diplomatic	外交の、外交上の
alongside	一緒に、並行して
narrative	物語、話
contamination	汚染、汚染物質
stark	正真正銘の、純粋な
refusal	拒否、拒絶
doctrine	教義、信条
organic	無農薬の、有機の
hypothesis	仮説、推測
evolutionary	進化的な、進化論の
archaeological	考古学の
subsequent	その後の、次の
contractor	請負業者、契約者
skeptical	懐疑的な、疑い深い
bribery	わいろ、賄賂
treadmill	踏み車
resume	再開する、続ける
hierarchical	階層的な、階級制の
nourishment	栄養、滋養
credibility	信頼性、信用
dissent	異議を唱える、反対する
proliferation	拡散、増殖
controversy	論争、議論
sympathetic	思いやりのある、共感的な
round up	寄せ集める、切り上げる
supposedly	たぶん、おそらく
patriotism	愛国心、忠誠心
disappearance	失踪、消滅
tragic	悲劇的な、悲劇的
implant	植え付ける、移植する
accounting	会計、計算
bout	試合、競技
hold over	を持ち越す、延期する
biased toward	に対する偏見、偏った見方
puppy	子犬、幼犬
semester	学期、学期間
refund	払い戻す、返金する
diabetes	糖尿病、高血糖症
organ	臓器、器官
prod	突く、呼び起こす
drawback	欠点、短所
prospective	予測される、期待される
pay off	全部払う、完済する
exclusively	排他的に、限定して
dosage	投与量、服用量
epic	大作、壮大な作品
consistently	一貫して、常に
believe in	を信じる、信用する
commerce	商業、商売
segment	区切り、部分
plebiscite	国民投票、普通選挙
pack up	を荷造りする、詰める
make ends meet	収支を合わせる、つじつまを合わせる
put A aside	Aを脇に置く、Aを放置する
conception	概念、考え
empathy	共感、感情移入
in hope of	への希望を抱いて、を期待して
conscience	良心、道徳心
bias	偏見、先入観
organism	生命体、生物
work out	体を鍛える、うまく行く、解決する
enzyme	酵素、生化学的触媒
circumvent	出し抜く、回避する
be tidied up	きちんと片づけた、整えた
clot	固まり、凝固塊
behavioral	行動上の、行動の
foremost	主要な、最も重要な
catalyst	触媒、刺激物
guilt	罪悪感、有罪
smooth over	丸く収める、穏便に済ます
seemingly	一見すると、表面上
dilemma	板挟み、窮地
scarcity	不足、欠乏
counterfeit	偽造する、偽造品を作る
perish	滅びる、死ぬ
expulsion	排除、除名
weed	雑草、草取り
roll up	を巻き上げる、巻く
obey	従う、服従する
prey	獲物、捕食対象
nobility	尊さ、高貴さ
inherent	本来の、固有の
fertile	肥沃な、多産の
assimilation	同化、吸収
removal	除去、取り除く
petition	嘆願、請願
reception	応接、歓迎
conceal	隠す、秘密にする
compliant	従順な、応じる
residence	住宅、居住地
protective	保護的な、保護する
initiate	始める、開始する
rebellion	反乱、暴動
convent	修道院、僧院
in person	直接に、対面で
sympathize	同情する、共感する
provoke	挑発する、引き起こす
give rise to	を生じさせる、を引き起こす
philosophical	哲学的な、思索的な
reminder	催促、注意喚起
disappointment	失望、期待外れ
ridicule	あざ笑う、嘲笑する
benevolent	慈悲深い、親切な
communal	共同の、共有の
compensation	補償、賠償
destitute	貧困の、困窮した
misfortune	不幸、災厄
level off	平らにする、水平にする
sinful	罪深い、悪い
routinely	日常的に、いつものように
medieval	中世の、時代遅れの
appreciation	感謝、称賛
rule out	を除外する、締め出す
hang on to	にしがみつく、執着する
exploit	偉業、業績
warrant	証明書、保証書
multitude	大勢、多く
designation	指定、選定
solely	単独で、専ら
mother-in-law	義理の母、義母
captivity	監禁、囚禁
forcible	強制的な、強い
fall under	支配下に入る、分類される
on the rise	上昇中で、増加中
ancestral	先祖の、祖先の
in place of	の代わりに、変わって
ruling	支配的な、主要な
favorable	好ましい、有利な
expedite	促進する、迅速化する
low frequency	低周波、低頻度
harsh	厳しい、過酷な
repay	返済する、報いる
inadequate	不十分な、不適切な
pull in	到着する、片側に寄る
surgeon	外科医、手術医
tutor	家庭教師、個別指導者
surrender	降伏する、投降する
undergraduate	大学生、学部生
conspicuous	目立った、顕著な
comprise	含む、構成する
put forth	を進める、出す
spur	刺激、触発
renovate	改修する、改装する
idealization	理想化、理想の実現
integrate	統合する、一体化する
decay	腐る、朽ちる
spite	悪意、恨み
cynical	皮肉な、冷笑的な
bleak	吹きさらしの、荒涼とした
devastation	荒廃、壊滅
keep up on	の最新状況を把握する、追いつく
portray	描く、表現する
dread	ひどく怖がる、恐れる
evoke	呼び起こす、引き起こす
come down with	病気などにかかる、罹患する
crisp	新鮮な、さっぱりした
loyalty	忠誠、誠実
tyranny	専制政治、圧政
minimal	最小限の、最低限の
adoption	採用、受け入れ
inheritance	継承、相続
reside	住む、居住する
blend in	溶け合う、調和する
moderately	適度に、適切に
comprehend	理解する、把握する
formidable	恐ろしい、手ごわい
magnitude	大きさ、規模
sexuality	性的関心、性的志向
paramount	最高の、最重要の
discord	不一致、不和
continuation	継続、持続
violation	違反、侵害
surpass	超える、勝る
ape	類人猿、大猿
geology	地質学、岩石の科学
tonic	強壮剤、健康促進剤
scarce	乏しい、不足している
elevate	上げる、昇進させる
stick with	に固執する、堅持する
nitrogen	窒素、化学元素
spectacular	壮観な、見事な
epoch	時代、歴史の節目
thermal	熱の、温度に関する
hold up	持ちこたえる、耐える
ironically	皮肉なことに、逆説的に
instructive	有益な、教育的な
infectious	伝染性の、感染する
metabolism	代謝、生体の化学反応
weaken	弱める、力を失う
unstable	不安定な、ゆらぎやすい
jump at	に飛びつく、すぐに受け入れる
sincere	誠実な、真剣な
awkward	ぎこちない、不器用な
plead	懇願する、お願いする
multinational	多国籍の、複数の国籍からなる
tolerant	寛容な、容認する
wilderness	荒野、未開の地
stand over	を監督する、延期する
microbial	微生物の、細菌の
ivory	象牙、象牙質の
hold out	持ちこたえる、我慢する
prohibit	禁じる、禁止する
slaughter	虐殺、大量殺戮
disastrous	悲惨な、惨事な
eruption	噴火、爆発
pick over	吟味して選ぶ、選び抜く
under warranty	保証期間中、保証されている
profitable	利益のある、収益性の高い
durable	耐久性のある、長持ちする
warranty	保証、保障
dismissal	解散、解任
administrative	運営の、管理の
replicate	複製する、再現する
sue	訴える、訴訟を起こす
burglar	強盗、泥棒
mortality	死亡者数、死亡率
hierarchy	階層、階級
feasible	実行可能な、可能性のある
density	密度、濃度
squalor	不潔、汚さ
cramped	狭苦しい、窮屈な
adverse	反対の、逆の
exclusive	閉鎖的な、内向的な
put an end to	を終わらせる、終了させる
edible	食べられる、摂取可能な
envelop	包む、包装する
sustenance	食糧、食料
aptly	適切に、適当に
premature	時期尚早の、早まった
clean cut	きちんとした、整然とした
parasite	寄生虫、寄生生物
ugly	醜い、見苦しい
deliberate	故意の、意図的な
smear	塗る、塗布する
wedge	くさび、楔形体
despicable	卑劣な、下劣な
stab	刺す、突き刺す
anecdotal	逸話の、物語性のある
whitewash	しっくい、モルタル
appalling	ぞっとするような、気味の悪い
fraternity	友愛、友情
supplant	取って代わる、置き換える
multiply	掛け算する、乗算する
intrinsic	本質的な、基本的な
diagnosis	診断、判断
cosmic	宇宙の、宙域の
progressive	進歩、進展
willingness	意欲、意志
strictly	厳密に、厳しく
integrity	誠実さ、誠意
microscope	顕微鏡
array	整列させる、並べる
evade	避ける、逃れる
pile in	どっと中に入る、一気に入る
overwhelm	圧倒する、制圧する
hunch	直感、本能
morbid	病的な、病気の
forensic	法廷の、裁判所の
convict	有罪とする、罪を宣告する
ply	精を出す、努力する
forefront	最前部、前線
unconscious	無意識の、潜在意識の
staunch	堅い、硬い
exploration	探査、探索
hasty	急ぐ、急ぎ足で
hostile	敵意のある、反感を持つ
pile up	を積み上げる、積み重ねる
provider	生産者、製造者
prestige	名声、評判
liver	肝臓
catch up	遅れを取り戻す、追いつく、遅延を補う
reimbursement	返済、返金
resent	憤る、怒る
frankly	率直に、直接的に
envious	羨ましい、うらやましい
face off	対決する、向き合う、立ち向かう
fraction	分数、小数
browse	拾い読みする、一部読む
seal	密閉する、封鎖する
norm	規範、基準
naval	海軍の、海軍のもの
speak for	を代弁する、の代理で話す、言い表す
versatile	多才な、多能な
surveillance	監視、見守り
submarine	潜水艦、水中艇
grain	穀物、穀類
prediction	予測、予想
rust	錆び、酸化
consult	相談する、話し合う
pill	丸薬、錠剤
potent	効能のある、効果的な
esoteric	秘儀の、神秘的な
remarkably	著しく、非常に
inspiration	ひらめき、閃き
comparable	比較できる、比べられる
supplier	供給者、供給元
supervisor	上司、長上
peg	くぎ、釘
regardless of	にも関わらず、それにもかかわらず
tighten	締める、絞る
force down	を無理やり飲み込む、強いて飲み込む
ambitious	野心的な、大志を抱く
quest	探求、探究
see through	を見抜く、見通す、透視する
mundane	平凡な、普通の
stay in touch with	と連絡を取り続ける、絶えず連絡する
logistics	調達路、供給路
vicinity	近所、近隣
throw off	を投げ捨てる、放り出す
eternal	永遠の、永遠不変の
mandatory	強制的な、強制力のある
diversity	多様性、多様化
go under	失敗する、破産する、失敗に終わる
not surprisingly	当たり前の事だが、もちろんのことだが
linguistic	言語学、語学
availability	可用性、利用可能性
latitude	緯度、緯線
equator	赤道、赤線
boast	自慢する、誇示する
rainfall	降雨量、雨量
diverse	多様な、多種多様な
barren	実を結ばない、結果を出さない
brink	瀬戸際、切羽詰まった状態
take on	を雇う、引き受ける、採用する
turmoil	騒動、混乱、騒ぎ
brutality	残忍性、冷酷さ、非情さ
prosper	繁栄する、発展する
successive	連続する、続ける、続く
mold	鋳型、型どる、型作り
fall through	失敗に終わる、駄目になる、台無しになる
conform to	に順応する、慣れる、適応する
stability	安定、平穏、均衡
insistence	主張、信条
toxic	有毒な、毒性の、毒のある
stand up to	に抵抗する、耐える、反抗する
excel	勝る、優れる、上回る
spectrum	波長分布、光の分布
detrimental	有害な、害のある、悪影響のある
modulate	調整する、微調整する、整合する
moderate	適度な、適切な、ほどよい
downright	真っすぐな、徹底的な、一貫した
bring off	を成し遂げる、達成する、完成させる
hedge	垣根、障壁、障害物
fall for	に夢中になる、騙される、引きつけられる
interact	相互作用する、互いに影響を与える
correctly	正しく、適切に
precision	正確さ、精度
synthesis	統合、統一
accessible	行きやすい、便利な
register for	に登録する、に記録する
foresee	予見する、予測する
optimistic	楽観的な、前向きな
envision	想像する、思い描く
resistant	抵抗する、反抗的な
weigh on	の重荷になる、負担になる、の負荷となる
allay	和らげる、軽減する
feel for	を感じる、同情する、を体感する
eradicate	根絶する、撲滅する
unintended	意図しない、計画しない
supervision	監督、指導者
play out	最後まで演じる、遊ぶ、最後まで続ける
mentally	精神的に、心理的に
dent	へこみ、凹み
noticeable	目立つ、際立つ
rebellious	反抗的な、抵抗的な
outrageous	無法な、法律を無視した
nasty	不快な、不愉快な
pull over	車を止める、車を停止させる
greenhouse	温室、ビニールハウス
bandage	包帯、絆創膏、ガーゼ
pat	軽くたたく、軽く打つ
soak	浸す、浸漬する
eventual	最終的な、究極的な
aim to	するつもりである、意図する
gross	全体の、総体的な
affluent	裕福な、富裕な
imperfect	不完全、未完成
measurement	測定、計測
substantially	実質的に、本質的に
disruptive	破壊的な、破壊力のある
inmate	収容者、被収容者
differently	異なって、異なる
wrap up	纏める、結束する
childbirth	出産、分娩
tell on	言いつける、密告する
midwife	助産婦、産婆
discomfort	不快感、違和感
pull through	を乗り越える、を超える
heal	癒す、治す
embarrassed	恥ずかしい、照れる
herd	群れ、集団
suburban	郊外の、郊外型の
placid	穏やかな、温和な
bounce back	持ち直す、回復する
bliss	至福、極楽
cross out	線を引いて消す、を抹消する
entice	誘惑する、魅惑する
provocative	挑発的な、挑戦的な
passionate	情熱的な、熱情的な
feminist	男女同権主義者、フェミニスト
extract	抜き取る、取り除く
elicit	引き出す、取り出す
deprivation	剥奪、取り上げ
confession	告白、自白
cascade	小滝、小さな滝
erroneous	誤った、間違えた
pass off	次第に消える、徐々に消える
testimony	証言、申し立て
paranoia	妄想症、幻想症
gutter	側溝、排水溝
settle up	を支払う、払い戻す
denounce	非難する、批判する
tacit	暗黙の、言わずと知れた
consent	同意する、賛成する
witch	魔女、魔法使い
give in	降伏する、投降する
subdue	鎮圧する、抑制する
coerce	強制する、強いる
crusade	聖戦、聖なる戦争
allegedly	申し立てによると、主張によると
shady	陰になった、日陰になった
intimidation	脅迫、威嚇
deceit	詐欺、騙し
ail	苦しめる、苦痛を与える
assert	主張する、主意を表す
rampage	大暴れ、乱闘
mentor	指導者、リーダー
confrontation	対決、対戦
presidency	大統領職、首相職
brush off	をすげなく断る、無視する、拒否する
purge	粛清する、浄化する
dire	悲惨な、哀れな
unethical	非倫理的な、不道徳な
neutral	中立の、公平な
abominable	忌まわしい、憎むべき
stuck up for	を支持する、を弁護する、を擁護する
exquisite	絶妙な、見事な
incremental	増加の、増大の
validity	有効性、効果性
discrepancy	不一致、食い違い
fix up	を修理する、決定する、を直す
momentum	運動量、運動エネルギー
rue	後悔する、悔いる
nutrient	栄養素、栄養分
absorption	吸収、吸取
physically	肉体的に、身体的に
thrive	繁栄する、隆盛する
notable	注目すべき、重要な
geography	地理、地理学
foam	小さな泡、微細な泡
duration	持続時間、持続期間
determination	決定、決断
reign	統治、治世
footing	足場、基盤
continuous	継続的な、持続的な
demographic	人口統計の、人口統計学の
explicit	明らかな、はっきりとした
along with	に沿って、従って
lessen	減らす、減少させる
portal	正門、入り口、門口
repeatedly	繰り返し、反復
harry	うるさく悩ます、蹂躙する、苦しめる
forbidden	禁じられた、禁止された
disturbing	邪魔な、迷惑な
par	同等、等価
across from	の向かいに、対面に
heath	荒野、野原
chemistry	化学、化学的な
malignant	悪意のある、悪意を持った
carcinogen	発がん物質、発癌性の物質
accumulate	蓄積する、貯蔵する
evacuate	避難する、逃避する
threshold	閾値
invaluable	貴重な、価値のある
miss out	機会を逃す、見落とす、見過ごす
ubiquitous	至る所に存在する、遍在する
burn out	を焼き尽くす、を灼き尽くす
formulate	策定する、計画する
feed off	から取って食べる、情報を得る、採取して利用する
hidden	隠された、隠秘の
botanist	植物学者、植物研究者
diplomat	外交官、外交官僚
skim over	流し読みする、ざっと読む、素早く読む
denote	表示する、示す
notorious	悪名高い、有名な
monarch	君主、王
faction	派閥、党派
animosity	敵意、敵対心
undermine	弱体化させる、衰退させる
ballot	投票用紙、選挙票
liability	責任、責務
successor	後継、次代
aggravate	悪化させる、劣化させる
signify	意味する、示す
loyal	忠実な、信念の厳格な
fortunate	幸運な、運の良い
giant	巨大な、大規模な
collision	衝突、対立
compelling	説得力のある、有力な
critical of	を批判する、非難する
plunge	突入する、侵入する
lava	溶岩、マグマ
devastating	壊滅的な、破壊的な
partial	部分的な、一部の
in line with	に従って、一致して、合致して
surge	波打つ、急に上がる
adamant	断固たる、固定的な
sole	単独の、単一の
consensus	同意、同調
rein	手綱、馬具
exorbitant	法外な、途方もない
depletion	枯渇、涸れる
split up	を分ける、分割する、区別する
regulatory	規制、制限
thoroughly	徹底的に、完全に
genetic	遺伝的な、遺伝による
indigenous	原産の、原生の
realistic	現実的な、現実に即した
allied	同盟を結んでいる、連携している
let up	やめる、弱まる、止める
volcano	火山、噴火口
cozy	居心地の良い、快適な
stubborn	頑固な、固執する
neat	きちんとした、整った
ease into	にゆっくりと入る、スムーズに入る
tidy	きちんとした、整った
play down	を軽く扱う、手軽に扱う
surgical	外科の、外科的な
go against	に反して、に逆らって、反対に
instantly	すぐに、直ちに、即座に
sting	刺す、突く
sunburn	日焼け、日焼け跡
add up to	結局、になる、結果として
venerable	由緒ある、歴史ある
play up	を重視する、強調する、優先する
assimilate	吸収する、同化する、取り込む
terminology	用語、専門用語
vault	丸天井、ドーム型の天井
indicative	表示する、示す
hang out	くつろぐ、リラックスする
dilute	薄める、希釈する
by contract	対照的に、比較して
suitor	求婚者、プロポーザルする人
endear	慕わせる、愛される
opportune	好機の、絶好の機会
proverbial	ことわざの、の
fall into	に属する、分類される
wry	ゆがんだ、歪んだ
shaggy	毛深い、毛むくじゃらの
drag on	長引く、続きすぎる
imperative	命令的な、指令的な
life expectancy	余命、生命の期間
ornate	華やかな、豪華な
drive off	を追い払う、排除する
molest	悩ます、困らせる
carry through	やり通す、達成する
maritime	海事の、海洋に関する
finish off	を完成させる、完遂させる
ascend	昇る、上昇する
stand down	身を引く、後退する
rant	怒鳴り立てる、大声で叫ぶ
blatant	露骨な、あからさまな
lay off	を解雇する、首にする
plausible	もっともらしい、信用できる
reaffirm	再確認する、再度チェックする
delve	掘り下げる、深く調べる
excerpt	抜粋、引用
timidity	臆病、怯える
coarse	粗末な、質素な
amass	蓄える、保存する
flaunt	誇示する、見せびらかす
yeast	酵母、きっかけ
frolic	戯れる、遊ぶ
procedural	手続きの、手順の
momentous	重大な、深刻な
counterclockwise	反時計回りの、逆回り
frosty	凍えるような、氷点下の
garner	集める、収集する
grow into	に発展する、進行する
light bulb	電球、光球
bogus	偽の、詐欺的な
horrify	怖がらせる、恐れさせる
prevent A from B	AをBから防ぐ、保護する
trilogy	三部作、三連作
dreadful	恐ろしい、怖い
bemoan	嘆く、嘆き悲しむ
deflect	そらせる、逸らす
turbulence	乱気流、渦
vista	眺望、景色
reliant	頼っている、信頼している
pollute	汚染する、汚す
binary	二の、二番目の
phony	偽物の、模造の
shake up	大きく変える、再編する
hoist	揚げる、炸製する
innate	生まれつきの、先天的な
colloquial	口語の、話し言葉の
abduct	拉致する、誘拐する
inaugural	就任の、着任の
act on	に従って行動する、従う
aquatic	水生の、水中の
stunning	驚くような、驚異的な
lag	遅れる、遅延する
unison	一致、合致
pastoral	羊飼いの、牧羊人の
launder	洗濯する、洗う
authoritative	権威ある、権力のある
impart	与える、授ける
crunch	噛み砕く、消化する
tentative	暫定的な、一時的な
revamp	改修する、修復する
flex	曲げる、湾曲させる
transcription	転写、写す
convertible	形を変えられる、形状を変化させる
water vapor	水蒸気、蒸気
colossal	巨大な、大きな
revitalize	活性化させる、刺激する
thee	汝を、あなたを
stub	使い残り、残り物
ulcer	潰瘍、胃潰瘍
indistinct	不明瞭な、ぼやけた
divulge	漏らす
keep A company	Aに同行する、Aとともに行く
hollow	空洞のある、中が空の
drop back	後退する、後ずさる
outcast	追放された、追い出された
prudent	用心深い、慎重な
debilitate	衰弱させる、弱める
insinuate	ほのめかす、示唆する
rub in	刷り込む、教え込む
oblivious	忘れっぽい、物忘れの激しい
traction	牽引、引っ張る
with all	にも関わらず、尽力しても
ruthlessly	冷酷に、冷徹に
scour	こすり洗う
genial	親切で愛想のよい、親しみやすい
substantive	実質的な、具体的な
repeal	廃止する、中止する
sloppy	ずさんな、いい加減な
tie up	を縛り上げる、束縛する
lamentable	哀れな、悲しい
interrogate	尋問する、質問攻めにする
episcopal	監督の、指導者の
treason	反逆、反乱
dainty	上品な、洗練された
dizzy	めまいがする、目が回る
concoct	練る、混ぜ合わせる
run against	にぶつかる、出くわす
scuttle	急いで行く、速く走る
loose	緩い
get on with	とうまくやっていく、スムーズに進める
admonish	訓戒する、警告する
in pursuit of	を追跡して、追いかけて
questionable	疑わしい、疑念を抱く
haughty	高慢な、傲慢な
experiment with	を試す、実験する
hefty	重い、沈重な
soothing	和らげる、軽減する
commend	褒める、賞賛する
chasten	懲らしめる、罰する
liken	例える、比較する
spring up	突然現れる、跳ね上がる
facile	安易な、手軽な
intuitive	直感的な、直観的な
capitalize	大文字にする、大型化する
folly	愚かな、馬鹿な
fend	避ける、回避する
coalesce	合体する、結合する
alleviate	和らげる、軽減する
exhale	吐き出す、放出する
slip by	そっと通り過ぎる、静かに過ぎる
enigmatic	謎めいた、神秘的な
gnaw	かじる、噛む
inter	埋葬する、埋める
loathe	嫌う、嫌悪する
real estate	不動産、物件
venue	現場、場所
cardinal	主要な、中心的な
lousy	ひどい、悪い
resurrect	復活させる、再生する
nestle	寄り添う、側にいる
temperament	気質、性質
dismay	がっかりさせる、失望させる
abort	中絶する、挫折する
elusive	捉えどころのない、不確定な
neurotic	神経症の、神経質な
confound	混乱させる、乱す
step down	降りる、身を引く
tenure	任期、期間
laughable	失笑を買った、笑われた
rebel against	に反抗する、対抗する
statistic	統計
clockwise	時計回りに、右回り
curtail	削減する、減少させる
entrust	委託する、依頼する
catastrophic	破滅的な、壊滅的な
fire up	点火する、起動する
come along	一緒に行く、共に進む
injurious	有害な、危害を及ぼす
back off	後退する、後ろに下がる
sign up	登録する、署名する
complementary	補完的な、補足的な
nasal	鼻の、鼻関連の
drawl	ゆっくり話す、遅く話す
dietary	食事の、食事関連の
peripheral	周辺の、近隣の
crumple	くしゃくしゃにする、よれる
prolong	延ばす、伸ばす
out of question	話にならない、不可能な
heave	盛り上がる、興奮する
molecular	分子の、微小な
gingerly	極めて慎重に、非常に注意深く
giddy	めまいがする、頭が回る
nomadic	遊牧の、移動する
recoup	取り戻す、回収する
strenuous	努力を要する、骨の折れる
demolish	取り壊す、壊す
scratch out	（線を引いて）消す、取り消す
meticulous	細心の、慎重な
acquaint	知らせる、通知する
treatise	論文、論説
oust	追い払う、追い出す
empirical	経験に基づいた、実績からの
fall away	弱まる、落ちる
startling	驚くべき、驚異的な
be aimed at	を狙っている、が意図されている
discrete	個別の、独自の
termination	終了、終わり
mull	良く考える、砂糖を入れて温める
overhaul	分解検査する、分析検査する
obligate	義務づける、強制する
wretch	みじめな人、不運な人
ardent	熱心な、情熱的な
run down	流れ落ちる、荒廃する
innermost	奥底の、深層の
volatile	揮発性の、揮発する
beguile	惑わす、混乱させる
come down to	結局、になる、に帰する
impoverished	貧しい、貧弱な
veto	拒否権、拒絶権
arduous	骨の折れる、困難な
crafty	狡猾な、ずるい
ferocious	どう猛な、激しい
bureaucratic	官僚的な、形式的な
construe	解釈する、解明する
derivative	派生した、派生する
mystic	神秘的な、不可解な
magnify	拡大する、増大する
impending	起こりそうな、可能性がある
gallant	勇敢な、勇気のある
appease	なだめる、鎮める
reverberate	反響する、反応する
groundless	根拠のない、無根拠の
invincible	無敵の、無敵な
deficient	欠乏した、不足した
pass for	として通る、通過する
singular	特異な、特有な
indifferent	無関心な、冷淡な
devolve	譲り渡す、移譲する
emanate	発する、出す
inconspicuous	目立たない、控えめな
pediatric	小児科の、子供の病気の
wartime	戦時、戦争時
pristine	元の、以前の
incompetent	無能な、劣る
bask	日向ぼっこする、日光浴する
duplicate	複製する、複写する
definitive	決定的な、断定的な
treachery	裏切り、背信
hamper	妨げる、邪魔する
back down	手を引く、撤退する
stern	厳しい、厳格な
chide	叱る、怒る
crackle	バチバチと音をたてる、クリックする
peek	ちらっと覗く、一瞬見る
obsolete	時代遅れの、古臭い
proportionate	比例した、均等な
viable	生存できる、生き抜く
grate	格子、格子状
bank on	を当てにする、依存する
neutralize	中和する、中立化する
graceful	優雅な、洗練された
fall off	減少する、減る
look down on	を見下す、軽視する
stingy	けちな、節約好きの
jab	突き刺す、突き立てる
dusky	薄暗い、昏い
subdivision	細分化、分割
focal	焦点の、中心的な
shun	避ける、回避する
wig	カツラ、人工の髪
discernible	識別できる、区別できる
exhilarate	陽気にさせる、楽しくさせる
customary	慣習的な、伝統的な
stick around	居残る、うろうろする
stuffed	詰め込んだ、充填した
mince	刻む、細かく切る
statutory	法定の、法的な
role model	お手本、模範
obstruct	邪魔する、妨害する
stature	身長、身の丈
talk down to	見下して話す、軽蔑して話す
recurring	繰り返し、再三
ignite	点火する、火をつける
make progress	進歩する、進展する
lose out to	に負ける、敗れる
ominous	不吉な、不運な
mitigate	和らげる、柔らかくする
vicar	牧師、神父
collateral	並び合った、横に並んだ
semantic	意味論の、意味学の
disquiet	不穏な、不安定な
hale	元気な、活発な
muse	深く考える、熟考する
autonomous	自律的な、独立的な
give over	を任せる、委ねる
gloat	満足げに眺める、得意に見る
relinquish	放棄する、捨てる
superfluous	余計な、過剰な
make over	を作り替える、改造する
stop A from doing B	AがBすることを止める、AがBするのを禁じる
scoff	嘲笑する、あざ笑う
cringe	すくむ、怯える
pissed	腹を立てた、怒った
despite	にも関わらず、とはいえ
benign	良性の、善良な
bring on	を引き起こす、誘発する
inflammatory	炎症性の、炎症を引き起こす
wharf	波止場、埠頭
press for	をせがむ、催促する
shear	刈り取る、収穫する
incumbent	責務がある、義務がある
wistful	もの悲しい、哀しい
disgraceful	恥ずかしい、恥じらいの
invest in	に投資する、資金を提供する
sinister	不吉な、縁起が悪い
sprout	芽、新芽
fraudulent	詐欺、欺瞞
improvise	即興で作る、その場で作り出す
turnaround	方向転換、方向変更
contentious	論争好きな、争い好きな
sag	たるむ、弛む
eat up	食べつくす、食べ尽くす
entreat	懇願する、頼む
gastric	胃の、胃部の
revoke	取り消す、撤回する
branch off	分岐する、枝を広げる
coax	説き伏せる、説得する
illicit	不法の、違法の
cut off	を断つ、切る
briskly	活発に、元気に
languish	弱る、衰える
avenge	仇を討つ、復讐する
divisive	不和の生じた、対立している
diminutive	とても小さな、極小の
beckon	手招きする
elude	逃げる、逃走する
enclose	囲む、同封する
espouse	支持する、後援する
imminent	差し迫った、切迫した
quash	鎮圧する、破棄する
get into	に入り込む、合格する
toddler	幼児、小児
peddle	行商する、売り歩く
relegate	左遷する、異動させる
waterfall	滝、瀑布
warden	監視員、見張り
mediocre	平凡な、普通の
derail	脱線させる、乱す
inflame	燃え上がらせる、炎上させる
urine	尿、尿液
watershed	分水嶺、分岐点
intermediary	仲介の、調停の
ultraviolet	紫外線の、UVの
wary	警戒している、注意している
dish out	盛り付ける、配膳する
vigorously	精力的に、エネルギッシュに
tint	色合い、色調
nudge	軽くつつく、ちょんと突く
quarrelsome	議論好きな、論争好きな
creepy	気味悪い、不快な
fragmentary	断片的な、部分的な
sorely	ひどく、非常に
vocational	職業の、仕事の
set aside	横に置く、取っておく
eschew	避ける
disguise	変装させる、見せかける
usher	案内係、ガイド
scattered	散らばった、散在した
jumble	乱雑にする、乱す
dormant	休眠中の、休止中の
corrupt	不正行為をする、カンニングする
crackdown	取り締まり、監視
malaise	不快感、違和感
bigotry	偏屈、頑固
fanatic	狂信者、過激派
stash	隠しておく、秘密にする
reconnaissance	偵察、偵察
proclamation	宣言、公言
inhibitor	抑制する人、制御者
to the point	適切な、要領を得た、適当な
rancor	怨恨、憎しみ
transcribe	複写する、複製する
catch on	流行する、受け入れられる、人気を博する
rift	切れ目、切り口
chant	単調な歌、一本調子の歌
edifice	建築物、構造物
rectitude	実直さ、誠実さ
puddle	水たまり
flurry	突風、突然の風
take A away from B	BからAを取る、BからAを除外する
quartet	四人組、4人組み
prelude	前触れ、予兆
penchant	強い好み、強い趣味
skew	斜めの、傾いた
read off	を読み上げる、すらすら読む、声に出して読む
on the run	逃走中の、走っている、逃げ足を使って
ensemble	全体的効果、全般的な影響
remedy	治療法、治療手段
rout	敗走、撤退
saving account	普通預金、通常の預金
resurrection	復活、再生
frost	霜、霜降り
locus	座標、位置情報
fatality	死者、災害、犠牲者
pathology	病理学、疾病学
whirl	渦巻く、旋回する
evasion	回避、避ける
fallacy	誤信、誤解
marrow	骨髄
hiatus	すき間、隙間
convergence	収束、集約
rebuff	拒絶、拒否
coffer	金庫、金箱
cohort	軍隊、仲間、部隊
retaliation	報復、仕返し
hyperbole	誇張、過大評価
bower	木陰、樹下
sanitation	衛生、清潔さ
pilgrimage	巡礼、巡り参り
outskirt	郊外、外れ
wince	ひるむ、後退する
crate	箱、容器
neutron	中性子、ニュートロン
testimonial	証明書、表彰状、認定書
set in	始まる、起こる、発生する
gala	祭り、祭典
provide A with B	AにBを供給する、AにBを提供する
what if	もし、ならば、仮に
clump	木立ち、木々
perimeter	周囲、環境
repository	倉庫、蔵
buffer	緩衝、緩和
courtship	求愛、愛の告白
turn down	を断る、拒む、拒絶する
hand off	を渡す、与える
shackle	手錠、手枷
prank	いたずら、悪ふざけ
shut out	を締め出す、閉め出す
contribute to	に貢献する、助けとなる
look to	を頼りにする、信頼する
antipathy	反感、嫌悪
configure	構成、設定、配置
libel	名誉毀損、中傷
enactment	立法、法制定
accreditation	認定、承認
invader	侵略者、侵入者
caliber	口径、直径
set off	を引き起こす、招く
get by	どうにか切り抜ける、何とか乗り越える
lighthouse	灯台、灯台
give off	を放つ、放出する、発散する
hang around	うろつく、徘徊する、歩き回る
connoisseur	鑑定家、評価家
masculinity	男らしさ、男性らしさ
glee	歓喜、喜び
pseudonym	偽名、偽の名前
bane	悩みの種、問題点
goad	突き棒、棒
abbey	修道院、僧院
wobble	ぐらぐらする、揺れる
opus	作品
quip	警句、警告の言葉
swoon	気絶、失神
bring out	を引き出す、引き起こす、招く
hub	中心部、核心
plume	飾り羽根、装飾用の羽
feud	確執、対立
cornerstone	礎石、基礎
petal	花弁、花びら
pass on	通り過ぎる、通る
screech	金切り声、高い叫び声
consolation	慰め、励まし
twitch	ぐいと引く、強く引っ張る
affirmation	断言、明言
ramification	分岐、分岐点
go over	を繰り返す、再び行う
entrepreneurship	起業家精神、創業者の心
entourage	側近、近侍
heresy	異説、違う意見
precursor	前触れ、予告
maverick	異端者、外道
misgiving	懸念、心配
sit in	座り込む、座って抗議する
nausea	吐き気、むかつき
overture	序曲、前奏曲
place limitation on	に制限を加える、限界を設ける
abdomen	腹部、腹の部分
down payment	頭金、手付金
anemia	貧血症、赤血球不足
tip over	ひっくり返る、転覆する
clean out	を一掃する、取り除く
contrition	悔み、後悔
specter	妖怪、妖精
ferocity	凶暴性、獰猛さ
stitch	一編み、一つ編み
law enforcement	法の執行、法の適用
rigor	厳格、厳重
tad	ちびっ子、子供
take up	を取り上げる、没収する
gall	憎しみ、胆汁
caveat	警告、警戒
fang	牙、犬歯
trade in	を下取りに出す、下取りにする
mason	石工、石匠
sheen	光沢、輝き
succumb	屈する、服する
archipelago	群島、諸島
trudge	とぼとぼ歩く、のろのろ歩く
incompetence	無能、無力
asteroid	小惑星、アステロイド
broom	ほうき、掃除道具
porcelain	磁器、陶磁器
torso	胴体、胴部
repercussion	反響、反応
slouch	前かがみ、前を向く
milieu	環境、周りの状況
communique	公式発表、公式通知
in search of	を探して、探索して、探る
homage	敬意、尊敬
hump	こぶ、隆起
efficacy	効能、効果
ballpark	概算、おおよその計算
plaza	大広場、広場
clout	影響力、影響
stay off	から離れる、距離を取る
excursion	遠足、日帰り旅行
hoax	悪ふざけ、いたずら
rapprochement	和睦、平和の協定
vindicate	疑いを晴らす、疑念を取り除く
anesthesia	麻酔、麻酔薬
mourning	喪中、服喪中
barracks	兵舎、兵営
wield	振り回す、使う
lift off	離陸する、飛び立つ
crescent	三日月、新月
assortment	詰め合わせ
enigma	不可解なこと、理解不能なこと
sabotage	妨害行為、邪魔
excavation	発掘、探し出す
get away with	を避ける、からやり過ごす
pick through	を探る、選りすぐる
trip up	を惑わす、つまづかせる
gazette	官報、公報
casket	小箱、小さな容器
talk up	を大袈裟にほめる、過大に評価する
mirage	蜃気楼、海市
put in	取り付ける、取り組む
handout	配布物、配布資料
in danger of	の危険がある、リスクがある
bribe	賄賂
pantry	食料品室、食品庫
psycho	精神病患者、精神障害者
benefactor	恩人、恩を受けた人
optics	光学、光の学問
fragmentation	断片化、分断
garland	花飾り、栄冠
grid	格子、格子状
sabbath	安息日、休息の日
even out	平らになる、安定する
oracle	神のお告げ、神託
subject to	の支配下にある、によると
corpus	文書資料の集成、文献集積
median	中央の、中心的な
plagiarism	盗用、窃取
quagmire	泥沼、泥の沼
coercion	強制、強要
crack up	大破する、くじける
smirk	にやにや笑う、微笑む
carcass	死骸、遺体
deterioration	悪化、劣化
ark	箱舟、ノアの方舟
ovation	熱烈な歓迎、熱心な歓迎
ailment	病気、疾患
burglary	侵入、進入
jihad	聖戦、宗教的な戦争
laureate	受賞者、授賞者
stud	種馬、繁殖馬
annuity	年金、退職金
keep up with	に遅れず付いていく、ついていく
horde	遊牧民族、移動する民
bravado	虚勢、見せかけ
orphanage	孤児院、孤児の家
surcharge	追加料金、追加費用
stepfather	継父、義父
impunity	免責、免除
give away	無償で配る、暴露する
patrician	貴族、貴人
supremacy	最高、至高
cove	入り江、湾
pulp	果肉、果実の肉
debtor	債務者、借金者
outburst	爆発、爆破
banquet	宴会、祝宴
head out	出発する、去る
decency	良識、良知
protagonist	主人公、主役
snag	突起、隆起
furrow	溝、水路
grow on	成長する、大きくなる
doctorate	博士号、博士の学位
scourge	むち、天罰
midday	正午、真昼
come before	の前に現れる、先立って現れる
tenor	進路、趣旨
probation	試用期間、試験期間
felon	重罪犯人、凶悪犯
hygiene	衛生、清潔
furor	激怒、怒り狂う
pigment	顔料、色素
swagger	いばって歩く、得意げに歩く
what is more	さらに、さらには
blackout	停電、電源断
graveyard	墓地、霊園
recognition	認知、認識
tense	時制、時間体系
outage	停電、電力断
graft	接ぎ木、挿し木
noun	名詞、単語
rodent	齧歯類、小型哺乳類
relapse	再発、再度の発生
lock in	を閉じ込める、囚禁する
conundrum	難問、難題
debacle	総崩れ、崩壊
fall back on	に頼る、信じる
phantom	幻影、幽霊
stagnation	停滞、滞止
jeopardy	危機、窮地
fetus	胎児、胎子
quantum	量子、量子単位
moth	蛾
incarceration	投獄、監獄送り
count on	に頼る、を当てにする
sling	つり縄、吊り縄
predicament	苦境、困難
magistrate	行政長官、行政官
stealth	内密、秘密
borough	自治区、自治体
arthritis	関節炎、関節の炎症
squadron	戦隊、部隊
stir up	をかき混ぜる、刺激する
paramedic	救急救命士、救命士
heyday	全盛期、最盛期
coroner	検死官、法医
lookout	警戒、眺望
pass over	を無視する、通り越す
dearth	欠乏、不足
cut in	切り込む、干渉する
decor	装飾、装飾品
hypertension	高血圧、高血圧症
rationale	理論的根拠、理論的基盤
reflex	反射、反射作用
mounting	取り付け、取り付けること
blast off	発射される、打ち上げられる
renegade	反逆者、反乱者
defamation	名誉毀損、中傷
infringement	侵害、侵犯
pass out	気絶する、出ていく
swoop	急降下する、急落する
roster	当番表、シフト表
biopsy	生体組織検査、生体サンプル検査
burrow	隠れ場所、隠れ家
breadth	幅、横幅
firearm	銃器、火器
foreground	前景、背景
scar	傷跡、傷痕
acquittal	無罪放免、無罪を宣告する
adultery	姦通、不倫
thermometer	温度計、体温計
rampart	城壁、城の壁
sire	雄親、父親
jug	水差し、じょうろ
intolerance	不寛容、偏見
axe	斧、戦斧
larva	幼虫、子虫
statesman	政治家、政府の役人
rendezvous	待ち合わせ、会合
caravan	隊、部隊
thug	刺客、暗殺者
break down	を壊す、解体する
cultivation	栽培、耕作
stronghold	拠点、基地
leash	ひも、くさり
take in	を摂取する、取り入れる
atheism	無神論、神を信じない考え
ransom	身代金、解放金
adjective	形容詞、形容する言葉
fluke	まぐれ当たり
guise	外観、見た目
propensity	傾向、流れ
squeal	悲鳴を上げる
homicide	殺人、人を殺す行為
in use	使用中の、利用している
thyroid	甲状腺、頸部の腺
replace A as B	BとしてAに取って代わる、BとしてAの位置を占める
cache	貯蔵庫、保存場所
due to	のせいで、の理由で
moderation	節度、節制
push through	押し通す、芽が出る
stockpile	備蓄、保存物
flagship	旗艦、主力艦
go back on	を裏切る、約束を破る
hypocrite	偽善者、偽善行為をする人
battalion	大隊、部隊
meteor	流星、流れ星
informant	通報者、情報提供者
retina	網膜、眼の内部の膜
attribute A to B	AをBに寄るものとする、AをBとみなす
soothe	落ち着かせる、安定させる
abduction	拉致、誘拐
cliche	決まり文句、決まった言葉
kinship	親族、家族
respite	一休み、休憩
snarl	唸る
gloom	暗がり、憂鬱
centerpiece	最重要、最も重要
platoon	小隊、部隊
pollen	花粉、植物の粉
inception	始まり、開始
genealogy	系譜、家系
insurgency	反乱、反乱軍
plaster	石膏、ギプス
remorse	後悔、過ちを後悔する
cupboard	食器棚、食器収納
go about	歩き回る、広まる
curator	学芸員、学芸スタッフ
paste	のり、接着剤
show up	姿を現す、姿を表わす
refinery	精製所、精練工場
iceberg	氷山、巨大な氷の塊
savior	救い主、救済者
prostitution	売春、売身
crap	くだらないもの、つまらないもの
hive	ミツバチの巣箱
pediatrician	小児科医、子供の医者
irresistible	抵抗できない、無力な
vain	うぬぼれが強い、自惚れた
sum up	を合計する、集計する
decipher	解読する、暗号を解く
exhort	勧める、推薦する
shitty	くだらない、ばかばかしい
side job	副業、アルバイト
no better than	と変わらない、同等の
instill	注入する、打ち込む
intractable	手に負えない、コントロールできない
negate	無効にする、取り消す
faulty	欠点のある、不完全な
murky	陰気な、暗い
whiff	ほのかな匂い、薄い香り
analogous	類似の、似ている
disgruntled	不満な、不機嫌な
idyllic	のどかな、穏やかな
receptive	受容性のある、受け入れ可能な
take pride in	を誇りにする、自慢する
laud	称賛する、賞賛する
military service	兵役、兵役の義務
perennial	一年中続く、年間を通じて
fraternal	兄弟の、兄妹の関係
overt	明白な、明確な
precocious	早熟の、早く成熟する
hearten	元気づける、励ます
utilization	利用、使用
conjure	唱えて呼ぶ、呼びかける
garnish	飾る、装飾する
existential	実存の、存在する
advise A on B	AにBについて助言する、AにBにアドバイスする
ascribe	のせいにする、責任を転嫁する
vengeance	復讐、報復
brash	せっかちな
goofy	間抜けな、馬鹿げた
implacable	和解しにくい、対立しやすい
poignant	強烈な、極端な
deterrent	抑止する、制止する
just around the corner	目前に来ている、すぐ近く
pertinent	関係がある、関連する
punitive	懲罰的な、罰するような
disband	解散する、ばらばらにする
lofty	高尚な、高潔な
glowing	白熱した、熱狂的な
therein	その中に、内部に
cerebral	脳の、神経の
abet	扇動する、煽る
vanguard	前衛、先駆者
adjoining	隣の、隣接する
eerie	不気味な、気味が悪い
stagnant	停滞している、静止している
contingent	起こりうる、発生可能な
latent	潜在している、隠れている
prescribed	所定の、指定された
staggering	千鳥足の、ふらふらの
as it stands	現状では、今のところでは
daring	大胆な、果敢な
wreckage	残骸、遺骸
flop	ぱったり倒れる、突然倒れる
incite	扇動する、煽る
pursuant	に従って、従い
warhead	弾頭、弾丸
interdisciplinary	学際的な、多分野の
scathing	痛烈な、厳しい
tyrant	暴君、専制君主
astute	鋭い、鋭敏な
on average	平均して、平均する
orbital	軌道の
alias	別名は、別称は
fumble	手探りする、取り損ねる、手間取る
whirlwind	旋風、つむじ風
detach	切り離す、分断する
unjust	不当な、不適切な
textual	本文の、正文の
sleek	なめらかな
amply	広々と、広大に
makeshift	その場しのぎの、仮の
in order	順序通りに、整った、順番通りに
unconventional	型破りな、非凡な
writ	令状、逮捕令
hesitant	ためらった、躊躇した
introspective	内省的な、反省的な
obscene	卑猥な、下劣な
apprehend	捕らえる、捕獲する
gasp	息をのむ
expatriate	自国を離れる、出国する
dim	薄暗い
heterosexual	異性愛の
exult	喜ぶ、うれしく思う
coy	恥ずかしいふりをした、照れくさいふりをした
heady	せっかちな、急かせる
embroil	巻き込む、関与させる
affective	優しい、親切な
keep A out of B	AをBに入れない、AをBに含めない
bipolar	二極ある、二極性がある
bullish	頑固な、固執する
adrift	漂流して、漂う
overblown	誇張された、過大評価された
aforementioned	前述の、先に述べた
come off	から取れる、外れる、取り外す
glean	集める、収集する
abdominal	腹部の、腹の
curt	そっけない、無愛想な
talk over	相談する、議論する
annul	無効にする、無効化する
forlorn	孤独な、寂しい
annex	添付する、別館
tawdry	安っぽい、安易な
terrestrial	地球上の、地上の
whim	気まぐれ、移り気な
celestial	天体の、星座の
rampant	自由奔放な、はびこった、漫然とした
devious	遠回りの、回り道の
quirky	風変わりな、奇抜な
sardonic	冷笑的な、皮肉な
close in	を閉じ込める
corroborate	裏付ける、裏を取る
confess to	を白状する、告白する、自白する
intestinal	腸の、腸管の
brandish	振り回す、使う
forestall	先んずる、先駆ける
forgo	差し控える、遠慮する
canine	犬の、犬用の
bring A in	を持ち込む、持参する
savvy	分かる、理解する
antiquated	時代遅れの、古い
resilient	弾力性のある、柔軟な
audacious	大胆な、勇敢な
austere	厳格な、厳重な
fluorescent	蛍光の、発光する
outstrip	追い越す、先行する
hum	鼻歌を歌う、ブーンと鳴る
whimsical	気まぐれな、移り気な
extol	絶賛する、高く評価する
drizzle	霧雨が降る、細かい雨が降る
vandalism	破壊行為、破壊的な行い
retarded	発達の遅れた、遅滞している
abrupt	突然の、急な
arcane	不可思議な、神秘的な
neural	神経の、神経系の
vile	下劣な、卑猥な
solemn	厳粛な、真剣な
translucent	半透明の、透けて見える
degenerate	退化する、後退する
obliterate	抹消する、消去する
falter	ためらう、躊躇する
in excess	過度に、余分に
brazen	厚かましい、無礼な
fluffy	綿毛の、ふわふわした
faded	色あせた、褪色した
civil rights	公民権、市民権、市民の権利
inundate	水浸しにする、水没させる
meander	蛇行する、曲がりくねる
paid vacation	有給休暇、給与付きの休暇
luxurious	豪華な
putative	推定の、予測の
sanguine	楽天的な、楽観的な
entrench	塹壕に入れる、防御する
deride	あざ笑う、嘲笑する
sort out	分類する、改善する
volatility	揮発性、揮発しやすい
flinch	尻込みする、躊躇する
grow out of	から生じる、生まれる
vindication	弁護、防御、弁明
medical checkup	健康診断、医療診断
diabetic	糖尿病の、高血糖の
incendiary	放火の、火災を引き起こす
be likely to	しそうである、する可能性が高い、ありそうな
deft	器用な、巧妙な
town twinning	姉妹都市提携、友好都市関係
vernacular	固有の、独自の、特有の
adjacent	隣接している、近接する
nominal	名目上の、形式上の
opaque	不透明な、明瞭でない
scrupulous	良心的な、誠実な
nourish	養う、育てる、支える
crappy	安っぽい、安価な
drench	ずぶぬれにする、水浸しにする
overstate	誇張する、過大評価する
narrow down A to B	AをBに限定する、制限する
insidious	陰湿な、卑劣な
lush	青々とした、生い茂った
send out for	お使いに出す、依頼する
devoid	欠けている、不足している
condone	大目に見る、寛大に扱う
arid	乾燥した、乾いている
nimble	機敏な、敏捷な
auditory	聴覚の、聞く力
accrue	発生する、起こる
dearly	心から、真心で
ostensibly	表向きは、外面的に
incompatible	非互換の、不適合な
obsessive	強迫観念のある、妄想的な
prodigious	驚異的な、素晴らしい
fickle	気まぐれな、不安定な
inscribe	刻む、彫る
ambivalent	相反する感情のある、矛盾した感情の
canny	抜け目のない
deplete	枯渇させる、使い尽くす
charred	黒焦げになった、焦げた
disparate	異なる、違う
put A into place	Aを実行する、Aを遂行する
turn away	追い返す、追放する
hideous	恐ろしい、恐怖な
irate	怒った、怒る
capitulate	降伏する、投降する
cull	摘む、間引く、取り除く
limit A to B	AをBに限定する、AをBに制限する
speculative	思索的な、考察的な
vet	獣医、動物医師
frigid	極寒の、極寒地の
push A back	Aを遅らせる、Aを抑制する
flounder	もがく、足掻く
leisurely	のんびりした、ゆったりした
align	揃える、整える
hit the books	猛勉強する、必死に勉強する
affiliated	提携した、連携した
gild	金塗る、金箔を貼る
fit A with B	AにBを備え付ける、AにBを装備する
upheaval	隆起、突起
contemplative	瞑想的な、沈思黙考の
dissipate	散らす、ばらまく
respiratory	呼吸の、呼吸に関する
hasten	急がせる、焦らせる
amidst	の中で、内部で
parking lot	駐車場、停車場
trinity	三位一体
infringe	侵害する、侵犯する
state of the art	最先端の、最先鋭の
wrath	激怒、怒り狂う
dazzling	眩しい
ghastly	恐ろしい、怖い
intimately	親密に、密接に
in particular	特に、特に重要な
genteel	上品な、優雅な
addictive	中毒性の、依存性の
rabid	狂った、狂気の
clinch	折り曲げて留める、折って固定する
malign	有害な、有毒な
quintessential	典型的な、一般的な
loot	戦利品、略奪物
martian	火星の、火星に関する
womb	子宮
admirable	見事な、素晴らしい
acquit	無罪宣告する、無罪を証明する
be laid up	寝込む、寝たきりになる
fret	いらいらする、怒る
count for	の価値がある、価値の高い
fervent	熱烈な、情熱的な
touchy	過敏な、敏感な
file a suit	提訴する、訴訟を提出する、告訴する
humiliating	屈辱的な、恥ずかしい
lavish	気前の良い、寛大な
in development	開発中の、進行中の
disposable	使い捨ての、一回きりの
grope	模索する、探求する
collegiate	大学の、大学に関する
insatiable	強欲な、貪欲な
err	誤る、間違える
futile	無駄な、非効率的な
motley	雑多な、多様な
noteworthy	注目に値する、見逃せない
lunge	突進、急進
brutally	残酷に、無慈悲に
detonate	爆発させる、破裂させる
intrude	侵入する、侵害する
raucous	耳障りな、騒々しい、うるさい
mortify	悔しがらせる、抑制する、嫌がらせる
infest	横行する、はびこる
tuberculosis	結核、肺結核
coronary	冠状動脈の、心臓に関連した
exacerbate	悪化させる、悪くする
horribly	恐ろしく、怖いほど
make it	やり遂げる、たどり着く、成し遂げる
momentarily	瞬時に、一瞬で
loom	ぼんやり現れる、織機、霧の中に
nibble	少しずつ食べる、つまむ
vice versa	反対に、反対もまた、逆に
verification	立証、証明
deserving	値する、価値がある
impromptu	即座に、すぐに
show off	見せびらかす、自慢する
insofar	その範囲で、その限りで
ooze	にじみ出る、漏れ出る
ballistic	弾道の、飛ぶ方向
greasy	脂っこい、油っぽい
crash down	崩れる、台無しになる、崩壊する
engulf	飲み込む、ゴクリと飲む
ceremonial	儀式上の、儀式的な
prodigy	莫大な、巨大な
provisional	暫定的な、仮の
extremist	過激派、極端な
numb	麻痺した、しびれた、無感覚な
expose A to B	AをBにさらす、露出する
wee	ちっぽけな、小さい
worthy	価値のある、貴重な
aggregate	集める、収集する
nightly	夜間の、夜の
overshadow	暗くする、暗にする
application form	申込用紙、申し込みフォーム
eject	追い出す、排除する
warren	飼育場、飼育施設
lurch	よろめき、ふらつき
spooky	不気味な、怖い
apprehensive	心配した、気になる
gear up	準備を整える、ギアを高速に入れる
classy	上品な、優雅な
consummate	完璧な、完全な
esteem	尊重する、敬う
glib	口達者な、話が得意な
in mind	頭に置いて、考慮して、考えに入れる
demur	異議を唱える、反対する
inadvertently	うっかりと、不注意にも
burly	たくましい、強靭な
ragged	ぼろぼろの、古びた
malicious	悪意のある、敵意を持つ
clueless	無知な、知識のない
fetal	胎児の、胎児に関する
rife	流行して、人気がある
depose	免職する、解雇する
indelible	消えない、永続する
proprietary	所有者の、独占的な
impeach	弾劾する、告発する
nod off	眠り込む、眠る、深く眠る
indispensable	欠かせない、必須の
glossy	光沢のある、つややかな
leach	ろ過する
disparage	見下す、軽視する
be critical of	に批判的である、否定的な
glut	満たす、充足させる
sumptuous	贅沢な、豪華な
abrasive	すり減らす、減らす
debase	堕落させる、道を踏み外させる
stunned	驚いた、びっくりした
equitable	公平な、平等な
contraceptive	避妊の、出産を防ぐ
salient	顕著な、明らかな
mend	繕う、修理する
vantage	有利、得する
clandestine	内密の、秘密の
cobble	修繕する、修理する
candid	率直な、正直な
insurgent	暴動を起こした、乱れた
hurtle	急いで行く、急ぐ
optic	目の、視力の、視覚の
serpent	蛇
synthesize	統合する、まとめる
fill out	に必要事項を記入する、記載する
dementia	認知症、記憶障害
garrison	駐屯地、兵士が居住する場所
threaten A with extinction	Aを絶滅の危機にさらす、危機に瀕させる
injunction	差し止め、停止命令
contaminant	汚染物質、環境に害を与える物質
do away with	を廃止する、除く、なくす
quarry	採石場、石を採る場所
from scratch	最初から、初めから、最初から
infusion	注入、注ぎ込む
realtor	不動産業者、土地や建物の売買を仲介する人
benefit from	で利益を得る、儲かる
head off	を回避する、阻止する、避ける
barrage	弾幕、多数の弾丸や意見
defection	離反、背いた
spate	多数、大部分
brethren	義兄弟、誓いで結ばれた兄弟、義弟
clutter	乱雑、無秩序
thump	ゴツンと叩く、強く打つ
civility	礼儀正しさ、マナーの良さ
moss	苔
ordinance	条例、地方自治体が制定する法律
buyout	買占め、大量に買い占める行為
leukemia	白血病、血液のがん
oxide	酸化物、酸と反応した物質
up front	前もって、率直に
pore	細孔、小さい穴
negligence	怠慢、怠ける、やる気がない
loophole	抜け穴、例外や逃げ道
braille	点字、視覚障害者用の読み書きシステム
proliferate	増殖する、数を増やす
tamper	改ざんする、偽装する
lexicon	語彙、言葉の集まり
perjury	偽証、虚偽の証言
diarrhea	下痢、便が液状になる状態
frankly speaking	率直に言うと、はっきりと言って
berth	寝台、寝る場所
perpetrate	犯す、違反する、犯罪を犯す
kick off	始める、追い払う
purport	趣旨、目的、意図
waver	揺らぐ、安定していない、ぐらつく
luncheon	昼食、正午頃に食べる食事
espionage	スパイ活動、情報を秘密裏に収集する活動
genesis	起源、始まり、出発点
janitor	用務員、建物のメンテナンス等を担当する人
alumnus	卒業生、卒業した人
antidote	解毒剤、毒を中和する物質
commandment	命令、指示、指令
wane	欠ける、不足している、欠損している
booty	戦利品、略奪物
abyss	深淵、非常に深いところ、底なし
subvert	覆す、覆い隠す、逆転させる
cynic	皮肉屋、皮肉を言う人
electrode	電極、電流を通す部品
drop by	に立ち寄る、短時間訪れる
sexist	男女差別主義者、男女間で不平等を支持する人
choreographer	振付師、ダンスや動きを設計する人
collusion	共謀、共同で犯罪を行う行為
gradient	勾配、斜面、傾斜
proffer	差し出す、提供する、出す
stutter	口ごもる、話すのをためらう、言葉に詰まる
lore	伝承、口頭や文書で伝えられる習慣や話
as a whole	全体の、すべてを含む、全般的な
culmination	絶頂、最高点、頂点
attrition	消耗、使い果たす、減少
cross over	越えて渡る、超えていく、通り過ぎる
disparity	相違、違い、不一致
combustion	燃焼、火を燃やす、酸化反応
permeate	浸透する、染み込む、広がる
sob	すすり泣く、涙声で泣く
glitch	小さな欠陥、小さい不備
levee	堤防、水害防止のための壁
sanctity	尊厳、威厳、尊重される資質
wreak	浴びせる、たくさんかける、振りかける
wilt	しおれる、萎む、元気をなくす
paralysis	麻痺、感覚、動きの喪失
pass up	逃す、失う、逸する
reprimand	懲戒、罰すること、訓練
die out	廃れる、流行が過ぎる、死に絶える
rapport	信頼関係、信用と信頼に基づく関係
plywood	合板、数枚の板を貼り合わせた材料
apprehension	気遣い、不安、配慮や心配
raider	急襲者、突然攻撃を仕掛ける人
nook	隅、角や端
genus	属、分類や所属
secession	離脱、退出すること
peter	細くなる、狭くなる
relive	追体験する、再び体験する
stand out	目立つ、注目を集める
help out	手伝う、助ける
scurry	せかせか動く、忙しなく動く
reverence	敬意、尊敬、尊重
shortfall	不足、足りないこと
ex-husband	元夫、以前の配偶者
pull down	取り壊す、解体する
preoccupation	没頭、集中すること
luster	光沢、艶、輝き
notation	表記、書き表示すること
patronage	後援、支援、援助
mess up	台無しにする、台無しにして価値や効果を無くす
penetration	貫通、一方から他方まで通過する
proprietor	所有者、何らかの物や権利を持っている人
come through	を通り抜ける、障害などを通過する
sinus	湾曲、曲がっていること
clamor	喧噪、うるさい雑踏や騒音
acronym	頭字語、初めの文字で作られる単語
resonant	共鳴する、感じ合う、同調する
bandit	盗賊、盗みを働く人
at the moment	今のところ、現状、現在点
discontent	不満、満足していない状態
unearth	発掘する、掘り出す、新たに見つけ出す
replenish	補充する、足りないものを追加する
skirmish	小競り合い、小さな争いや戦い
gust	突風、突然の風
wisdom tooth	親知らず
has yet	今のところ、現状、現在点
primate	霊長類、霊長動物
handcuff	手錠、人を拘束する装置
hoof	蹄、馬や牛などの足の一部
revel	楽しむ、何かを心から喜ぶ
out of nowhere	いきなり、突然に、予告なく
citation	引用、他人の言葉や文章を取り上げる
complexion	顔色、肌の色調
tout	うるさく勧誘する、しつこく誘う
fiat	命令、指令や要求
quell	鎮める、落ち着かせる
envoy	使者、代理人や遣使
fodder	飼料、動物のエサ
comptroller	会計監査官、会計をチェックする専門家
speaking of which	と言えば、それについて
excise	物品税、商品にかかる税金
bank account	銀行口座、銀行での預金や取引のアカウント
punctuate	句読点をつける、文章に区切りを入れる
continuum	連続体、途切れることなく続くもの
hand out	配布する、分け与える
diaper	おむつ、おしめ
wear off	擦り切れる、摩耗する、徐々に減る、少なくなる
ferment	発酵体、発酵を引き起こす物質
pleading	嘆願、懇願やお願い
scum	薄皮
puncture	穴を空ける、穴を開ける
fledgling	駆け出し、初心者
patriarch	家長、家族の主
public official	公務員、官僚
mower	芝刈り機
compare A to B	AをBと比べる、AをBと対比する
iteration	反復、繰り返し
paraphrase	言い換え、再表現
revulsion	嫌悪、反感
beacon	のろし、目印、合図
rectangle	長方形、四角形
tarnish	曇らせる、濁らせる
defiance	反抗、反発
blister	水膨れ、水疱
chuckle	含み笑い、ほくそ笑い
sham	見せかけ、仮装
glimmer	かすかな光、微かな光
onslaught	猛攻撃、激しい攻撃
back up	を後援する、後退させる
arson	放火、火をつける
euphemism	婉曲表現、遠回しの表現
overdose	過剰摂取、過食
yawn	欠伸をする、あくびをする
altruism	利他主義、無私無欲
enclave	飛び地、飛地
banter	冗談、笑い話、おどけ
buckle down	精を出す、全力を尽くす、尽力する
endemic	風土病、地域病
asylum	亡命、亡命者、亡命生活
transmit A to B	AをBに伝染させる、移す、感染させる
splice	組み継ぎする、繋ぐ、接合する
emblem	象徴、何かを代表するものや事象
farce	茶番、喜劇
foray	不意打ち、突撃、急襲
bundle	束、一揃い
conflagration	大火災、大規模な火事
compliment	褒め言葉、賞賛、称賛
finesse	巧妙な処理、うまい対処、手腕
fume	臭い煙、臭気、悪臭
squander	浪費する、無駄遣いする、散財する
tame	飼い慣らされた、家畜化された、馴染む
absurdity	不条理、不合理、矛盾
break through	突破する、切り抜ける、乗り越える
smite	強打する、激打する、ぶん殴る
lobe	耳たぶ、耳垂
scribble	落書きする、書き散らす
tangle	もつれさせる、絡ませる、混乱させる
sit by	傍観する、見物する、見守る
integrate A into B	AをBに統合する、AをBに併合する、AをBに結合する
grudge	恨み、怨み
slick	なめらかな
herald	使者、使い、代表者
revile	悪口を言う、中傷する、非難する
ambush	待ち伏せ、待ち構え、伏兵
parity	同等、等価、相当
strew	ばらまく、散布する、拡散する
replace A with B	AをBに置き換える、AをBと交換する、AをBで代用する
bastion	要塞、城塞、砦
deal in	取り扱う、携わる、処理する
complicity	共犯、共謀者、仲間
renounce	放棄する、断念する、諦める
extradition	引き渡し、渡す、提供する
brawl	乱闘、乱打、暴行
clientele	依頼人
reinstate	復帰させる、復元する
grant A to B	BにAを供与する、BにAを提供する
live up to	に従って動く、期待に答える
ascent	上昇、昇格
gorge	峡谷、渓谷
solace	慰め、安堵
stop by	立ち寄る、寄る
knack	コツ
retribution	報復、復讐
sludge	汚泥、泥沼
contingency	不測の事態、突発的な事態
registry	登記、記載
acumen	洞察力、識見
wrangle	口論する、議論する
associate A with B	AとBを関係づける、AとBを連携させる
anarchy	無秩序、混沌
labyrinth	迷宮、迷路
let A go	Aを解雇する、自由にする
smother	窒息させる、息を止める
diffusion	拡散、広がり
blight	疫病、感染症
foyer	休憩室、待合室
subversive	破壊する、壊す
impediment	障害、障害物
pawn	抵当、抵抗
payroll	給与、給料
quirk	変な癖、特異な癖
curfew	門限、帰宅制限
pamper	甘やかす、ひねくれる
stoke	燃料をくべる、火力を増す
at hand	手元に、近い将来
disintegration	崩壊、崩壊状態
impasse	行き詰まり
rendition	演出、舞台監督
persecute	迫害する、圧迫する
bounty	寛大さ
hindsight	後知恵、振り返り
avatar	権化、象徴
brat	小僧、若者
jettison	放棄、断念
taunt	罵倒する、侮辱する
wiggle	ぴくぴく動かす、ひくつかせる
allusion	暗示、示唆
procurement	調達、供給
aberration	逸脱行為、妨害行為
backlash	激しい反発、強い反響
euphoria	陶酔、夢中
end up	最終的に、することになる
eligibility	適格性、妥当性
sewage	下水、排水
dictum	口述、口頭説明
manure	肥料、施肥物
populace	民衆、大衆
distance A from B	AをBから遠ざける、AをBから隔てる
centennial	100年祭、百年祭
stint	切り詰める、節約する
omen	前兆、予兆
teem	群がる、集まる
picket	くい
acknowledgement	承認、認可
straddle	またがる、乗り越える
chasm	裂け目、割れ目
complacency	自己満足、自己陶酔
pedigree	血統、家系
adversity	逆境、困難
believe it or not	信じられるか、そうでないか、信頼できるか
heap	塊
rationality	合理性、合理主義
at random	無作為に、手あたり次第に
blood vessel	血管、動脈
philanthropy	博愛、普遍愛
look into	を研究する、を調査する
cynicism	皮肉、冷嘲
mitigation	緩和、和らげる
morgue	遺体安置所、遺体保管所
pod	さや、刃物の保管用ケース、植物の部分
leave off	脱いだままでいる、着ずにいる、脱衣したまま
alienation	疎外、遠ざける、孤立させる
corporal	伍長、軍曹、下士官
up for	に参加しようとしている、参加しようとしている、加わろうとしている
funk	臆病、怯える、気が小さい
deluge	大洪水、大水害、氾濫
intestine	腸、腸管
match A with B	AをBと適合させる、AをBに合わせる、AをBに調整する
liturgy	典礼、儀式
sarcasm	皮肉、嘲笑、冷笑
anthem	賛歌、賛美歌
demolition	解体、崩壊、解散
propagate	広める、拡大する
romp	ふざけ回る、遊び回る、馬鹿騒ぎする
obituary	死亡記事、訃報、死亡通知
adjunct	付属物
crusader	十字軍、聖戦
seminary	神学校、神学院
exaggeration	誇張、過大評価
back out	取り消す、約束を破る、撤回する
impetus	運動力、活力、動力
compilation	編集、修正、校正
semiconductor	半導体、電子部品
gut	腸、大腸、小腸
measles	麻疹、発疹
smuggler	密輸業者、密輸人
miscarriage	失敗、流産
bystander	傍観者
epicenter	震源地
improvisation	即興、アドリブ
lineage	系統、体系、系列
recourse	依頼
replace A by B	AをBで置き換える、AをBで代用する、AをBに変える
foreman	親方
rupture	破裂、割れる、爆破
spurn	追い払う、排除する、締め出す
hepatitis	肝炎
classify A as B	AをBに分類する、AをBで仕分けする
pun	駄じゃれ
as it turns out	結局のところ、最終的に、ついに
hallucination	幻覚
arithmetic	算数、算術、計算
pitfall	落とし穴、罠
stunt	発育を妨げる
menopause	閉経、更年期、停止
inhibition	禁止
to be honest	正直に言うと
litigation	訴訟
hull	外皮、船体
exposition	展示会
euthanasia	安楽死
lunatic	精神異常者
obscenity	わいせつ
manifesto	宣言書
absentee	欠席者
locale	現場
manslaughter	過失致死
insurrection	暴動
enclosure	囲い
allow for	を考慮に入れる、余裕を持つ
placate	なだめる
funnel	漏斗
kettle	やかん
pertain	関係する
malpractice	不正行為
dual citizenship	二重国籍
outpatient	外来患者
secede	離脱する
whack	打つ
calculus	結石、微分、積分
inoculation	予防接種
chip in	寄付する、金を出す
piracy	海賊行為
truce	休戦
ruckus	大騒ぎ、騒乱
cardiovascular	心血管の
surrogate	代理人
vial	ガラス瓶
conglomerate	密集した
palatable	美味しい
get in on	加わる、乗り込む
tepid	生ぬるい
annihilate	全滅させる
gruesome	ぞっとする
precarious	不安定な
cervical	頸部の
symmetry	対称
treasurer	会計係
mural	壁の
in fact	実際
consecrate	奉献する
bloated	むくんだ
extradite	引き渡す
complimentary	無料の
corrosive	腐食性の
defiant	反抗的な
palpable	触れることができる
muffle	包む
generalized	一般化された
tinge	色合い
glisten	輝く
exacting	厳しい
hang on	しがみつく、頑張る
flagrant	極悪非道の
nuptial	婚礼の
best for	～にとって最良の
predatory	肉食の
impaired	障害のある
obnoxious	不愉快な
stalwart	堅固な
lock up	刑務所、留置所
stately	風格のある
shoddy	見掛け倒しの
radiant	輝く
glint	きらめく
zest	熱意
requisite	必要な
toxic to	に有毒な
autistic	自閉症の
flit	すいすい飛ぶ
gregarious	群生した
in advance	前もって、あらかじめ
majestic	雄大な
elucidate	解明する
waiver	免除
ailing	病んでいる
perverse	ひねくれた
vogue	流行
venom	毒
ethereal	空気の様に軽やかな
interpretive	解釈の
let out	外に出す、解放する
ultimatum	最終通告
cardiac	心臓の
infrared	赤外線の
posh	豪華な
appellate	上訴の
conflict with	と相容れない、合わない
boldly	大胆に
for once	今回だけ
atone	償う
obese	肥満体の
fluctuate	変動する
defunct	消滅した
incarcerate	投獄する
lax	手ぬるい
grueling	厳しい
supple	柔軟な
fall out of favor with	に嫌われる
idiosyncratic	特異な
perceptual	知覚の
sparse	希薄な
sectarian	宗派の
categorize A as B	AをBの範疇に分ける
tenuous	薄い
stalemate	行き詰まり
whereabouts	どの辺りに
antagonize	敵に回す
gobble	がつがつ食べる
belligerent	好戦的な
ash	灰
outwit	出し抜く
lubricate	潤滑させる
vigilant	警戒した
distraught	取り乱した
synonymous	同義の
sporadic	散発的な
bode	予言する
zinc	亜鉛
dogged	頑固な
inept	不適当な
ventilation	換気
on balance	考慮すると、結局
taut	びんと張ってある
jostle	押し合う
stellar	星の
exude	滲み出させる
thorn	とげ
fleeting	つかの間の
attentive	注意深い
tantalizing	じれったい
walk off with	から歩いて出る、立ち去る
culinary	料理の
natural disaster	自然災害
accentuate	強調する
sordid	むさ苦しい
pilfer	くすねる
assail	暴行する
airborne	空輸の
keep A away from B	AをBから遠ざける
blurt	うっかり話す
encroach	侵入する
as before	以前のように、以前と同等に
engender	醸し出す
condescend	謙遜する
on standby	待機して
distract A from B	Aの気をBからそらす
pulmonary	肺の
notoriously	悪名高く
detract	損なう
remedial	治療する
trivia	些細なこと
discretionary	任意の
pessimistic	悲観的な
inside out	裏返しに、ひっくり返して
pseudo	偽りの
antecedent	先行する
stick to	にくっつく
harrowing	悲惨な
flawless	完璧な
adept	熟達した
bulky	かさばった
glitter	きらきら輝く
intrepid	勇敢な
impersonate	役を演じる
lisp	舌足らずに発音する
taint	腐敗、汚点
deceptive	当てにならない
contextual	文脈上の
grandiose	壮大な
meager	貧弱な
anew	新たに
conceivable	考えられる
verbally	口頭で
pacify	なだめる
turbulent	荒れ狂った
peruse	熟読する
erratic	不安定な
smug	独り善がりの
congregate	集まる
cower	縮み上がる
torrent	急流
uncanny	不気味な
manifest	明白な
abhor	嫌悪する
call on	を訪問する、要求する
moot	議論する
have access to	を利用できる
tremor	震動
squabble	つまらない口論
wand	杖
hydraulic	油圧の
buoyant	浮力のある
sales quota	売上ノルマ
dissect	解剖する
seductive	魅惑的な
stringent	厳格な
overdue	延滞した
ablaze	燃え立っている
aggrieved	感情を害した
jagged	角立った
rustic	田舎の
gritty	砂の入った
flimsy	薄っぺらな
heartfelt	心からの
at fault	落ち度がある、咎められるべき
boisterous	騒々しい
play at	起用する、遊ぶ
whore	売春婦