as a result	結果として
however	しかしながら、どんなに～でも
environment	環境
reduce	を減らす、縮小する
instead	代わりに、その代わり
in order to	～するために
vehicle	乗り物、車
recommend	を推薦する、を勧める
improve	を改善する、改良する
recently	最近、このごろ
customer	顧客、お客様
discover	を発見する、見つける
common	共通の、共同の
in particular	特に、とりわけ
disturb	を阻害する、（人の）邪魔をする
moreover	さらに、その上
not only A but also B	AだけでなくBもまた
a number of	たくさんの
be likely to	する可能性が高い、しそうになる
benefit	利益／に利益をもたらす
deal with	に対処する
solution	解決法、解明
inform	情報を与える、に知らせる
disease	病気、疾患
therefore	それゆえ、だから
unfortunately	残念なことに、不幸にも
device	装置、仕掛け
attractive	魅力的な、興味をそそる
climate	気候
end up	最終的に、することになる
evidence	証拠
estimate	を推定する、評価する
argue	だと主張する、感情的に論じる
according to	によると
meanwhile	一方で、他方で
entirely	完全に、全く
publish	を出版する、発行する
melt	溶ける、を溶かす
expense	費用、出費、犠牲
contain	を含む、が入っている
similar	似ている、類似の
government	政府、行政府、内閣
modern	現代的な、現代の
million	100万
scientist	科学者
pollution	汚染、汚れ
foundation	土台、根拠、設立
remove	を取り除く、を除去する
compare	を比較する、をたとえる
replace	を取り換える、を交換する
lead to	に導く、～につながる
furthermore	さらに、その上
result in	結果として、結果～になる
profit	利益、もうけ
remain	のままである、残る
organize	を組織する、を編成する
suffer from	で苦しむ、悩まされる
emphasize	を強調する、力説する
more and more	ますます多くの、更に
experiment	実験、試み
consume	を消費する、消耗する
development	発展、発達、開発
detect	を検出する、を感知する
extremely	極端に、過度に
employment	雇用
by chance	偶然に、たまたま
unlike	と異なって、とは違って
properly	適切に
repair	を修理する、修繕する
in addition	追加として、さらに
complicated	複雑な
until	までに、まで
on the other hand	一方で、他方で
arrest	を逮捕する、捕まえる
betray	を裏切る、をだます
survey	調査／を見渡す
affect	に影響を与える
consider	について考える、だと見なす
portable	持ち運べる、携帯用の
remind	に思い出させる、に気付かせる
ability	能力、力量
allow	を許可する、許す
quality	質、特性
construction	建設、構造、建造物
develop	を発達させる、を開発する
permission	許可、認可
mess	混乱、錯乱
convert	を変える、転換する
resident	住民、居住者
provide	を供給する、提供する
metal	金属
immediately	即座に
predict	を予想する、を予測する
religion	宗教、信仰
currency	通貨、流通
restore	を元に戻す、を修復する
accompany	に付き添う、に同行する
in detail	詳細に
no longer	もはや～でない
nevertheless	にも関わらず
probably	おそらく
in contrast	対照的に、これに対して
for instance	例えば
additionally	加えて、さらに、追加で
anxiety	心配、不安
for example	例えば
brain	頭脳、脳
certain	ある、確信している
pain	痛み、苦痛
in response to	に応じて、に反応して
stare at	をじっと見つめる
involve	を含む、を巻き込む
at the same time	同時に、一斉に
preserved	保存された
be known as	として知られている
accurate	正確な、的確な
analyze	を分析する、分解する
a variety of	いろいろな、さまざまな
obtain	を手に入れる、を獲得する
sympathy	同情、思いやり
flexibility	しなやかさ、弾力性、柔軟性
approach	に近づく、接近する
manage	何とかうまくやる、管理を行う
reach out	手を延ばす、手を差し出す
for fear of	を恐れて
on behalf of	の代わりに
on account of	のため
artificial	人工的な、人造の
prevent A from B	AをBから防ぐ
rather than	よりむしろ、ではなくて
slightly	わずかに、少し
measure	措置、測るもの／を測る
be born with	生まれつき、生来の
waste	を浪費する／浪費、廃棄物
since then	それ以来、それ以降
turn A into B	AをBに（質的に）変える
fertilizer	肥料
made of	で出来ている
adopt	を自分のものにする、を取り入れる
raise	を上げる、持ち上げる
avoid	を避ける、を回避する
make sure	を確かめる、必ず手配する
participate in	に参加する
achieve	を達成する、到達する
tolerate	に耐える、寛大に取り扱う
journey	旅、旅行
get along	うまくやる、仲良くやる
keep up with	に遅れず付いていく
production	生産、製造
cell	細胞
such as	のような
complete	完全な、全部の
annually	毎年の、年一回ずつ
psychologist	心理学者
invest in	に投資する
demand	要求、需要／を要求する
respond	反応する、と返答する
valuable	貴重な、価値のある
witness	目撃者、証人／を目撃する
poverty	貧困、貧乏
embarrass	を恥ずかしがらせる
enlarge	を拡大する
ingredient	材料、原料、成分
overall	全体的な、全部の
spend	を費やす、使う
purchase	を購入する／購入
brilliant	優れた、光り輝く
revolution	革命
in charge of	の担当をして
previously	以前は、前もって
feature	特徴／を目玉とする
excuse	言い訳／を許す
rely on	に頼る、を当てにする
vote for	に賛成する、に投票する
decrease	減少する、を減らす／減少
frequent	頻繁な、しばしば起こる
theory	理論、学説
gravity	重力、引力
translate	を翻訳する、通訳する
equipment	装置、設備
rare	まれな、珍しい
decide	決心する、解決する
bank account	銀行口座
amount	量、額
constant	絶え間ない、一定の
efficient	効率のいい
available	利用できる
particular	特定の
locate	見つける、位置を突きとめる
recommendation	推薦
apply to	に適用する
politely	丁寧に
accidentally	誤って、知らずに
satisfy	を満足させる
appointment	予定、約束
chemical	化学物質／化学の
attach	を貼り付ける
permit	を許可する
prevent	を妨げる、予防する
increase	を増やす、増大させる
luxury	贅沢な／贅沢
decade	10年間
enormous	非常に大きい
replacement	置換
in touch	連絡中、連絡が取れて
confuse	を混乱させる、区別がつかない
produce	を生産する、産出する
economy	経済、節約
celebrate	祝う、祝福する
cope with	に対処する
imitate	模倣する、真似る
assignment	割り当て
certainly	確かに、間違いなく
behave	振る舞う
instrument	楽器
temporary	一時的な
capable of	ができる、可能で
arrange	整える、を配置する
occasion	特定の時、行事、祭典
take after	をまねる、に似る
guilty of	罪を犯して
work out	練習する、運動する
promote	を促進する
electricity	電力、電気
composer	作曲家
creature	生き物
substance	物質、実態
graduate	を卒業する
furniture	家具
medicine	薬
at last	ついに、やっと
attitude	態度
borrow	を借りる
sufficient	十分な、足りている
hear from	から便りがある、連絡をもらう
directly	直接、直接的に
historic	由緒のある、歴史に残る
barely	かろうじて、やっと
delete	を削除する、消す
urgent	緊急の
generous	気前のよい、寛容な
cruel	残酷な、ひどい
celebration	お祝い、祝典
reflection	反響、反射
concept	概念、観念
whisper	ささやく、を耳打ちする
deposit	お金を預ける、を預金する
apology	謝罪
deceive	を欺く
establish	を設立する、創設する
endure	を我慢する、耐える
dispose	廃棄する
statistics	統計
compromise	妥協、和解
terminal	終りの、末端の
formation	形成、構成
envelope	封筒
quarrel	喧嘩、口論、言い争い
handle	を手で扱う、に対処する／取っ手
condition	状態、条件
punish	を罰する、懲らしめる
from time to time	時々
in demand	需要のある
stand out	目立つ、すぐれている
in the meantime	とりあえず、それまでは
to some extent	いくらか、ある程度
at any cost	どんな犠牲を払っても、何がなんでも
on the contrary	その反対で、それどころか
lose face	面子を失う、恥をかく
answer for	責任を負う、引き受ける
insist on	するように強く求める、強調する
despite	にも関わらず
worth	の価値がある、（～するに）値する
not always	必ずしもではない、いつもとは限らない
spread	を広げる、広がる
at that time	あの時は
in common	共通して
be affected by	の影響を受ける
luckily	幸いなことに、幸運にも
not yet	まだ
in response	に応じて、に対応して
have effects on	に影響を与える
taste	味／な味がする
in advance	前もって、事前に
confident	自信のある
one day	ある日、いつか
five senses	五感
sight	見ること、視力
electric	電気の
receive	を受理する、受け取る
ankle	足首
related to	に関連する
fear	を恐れる、恐がる／恐れ
active	活動的な、活気のある
lesser	より少ない、いっそう少ない
degree	程度、度
effect	効果、影響、結果
cause	原因／の原因となる
particularly	特に、とりわけ
suffer	を患う、苦しむ
immune	免疫の、免疫のある
disorder	無秩序、混乱
mental	精神の、心の
physical	身体の、肉体の
intend to	するつもりである、する意図がある
at present	現在は
make a difference	違いを生む
opportunity	機会、好機
on purpose	故意に、わざと
exceptionally	例外的に、非常に
almost	ほとんど、たいてい
characteristic	特有の、独特の
similar to	に似ている
as to	に関して
civilization	文明
represent	を表す、を代表する
collapse	崩壊する、つぶれる
insult	を侮辱する
mixture	混合物
isolated	孤立した、隔離された
punctual	規則正しい、時間通りの
responsible	責任がある、責任が伴う
frightened	恐ろしかった
guarantee	を保証する／保証
blame	を非難する
anniversary	～周年、記念日
violate	違反する
delay	を遅らせる、先延ばしにする
surround	を取り囲む、を包囲する
immigrate	移住する
correct	正確な／を訂正する
landscape	風景、眺め
instinct	直感、本能、勘
policy	政策、方針
obviously	明らかに、明白に
strangely	不思議なことに、奇妙に
chase	を追跡する、追いかける／追跡
pour	を注ぐ、激しく降る
at one time	一度に
all the way	はるばる、わざわざ
show up	現れる
pull away	引き離す
try out	を試す、十分に試してみる
break into	に押し入る
call it a day	終了する、仕事を切り上げる
be awake	目を覚ましている
issue	問題、（雑誌などの）号
elderly	年配の
brightness	輝度、明るさ
have an effect on	に影響を及ぼす
indoor	室内／屋内の
senior	ポストが上の、上級の／年上の人
natural	当然の、自然の
be adjusted to	に調整する
specific	具体的な、特定の
heart rate	心拍数
be beneficial to	に有益である
what is called	いわゆる
symmetry	対称、左右対称
each other	お互い
advantage	有利、利点
knee	膝
check for	を調べる
after all	結局
over time	超過勤務、延長時間
What is more	さらに、その上
for some time	しばらくの間
at a time	1度に
parking lot	駐車場
all around the world	世界中の
copyright	著作権
charge	非難、料金、管理／に請求する
director	監督、指導者、役員
in reality	実際に、現実に
actually	実際に、現実に
compose	を構成する、作曲する
greet	を出迎える、に挨拶する
depend on	に頼る
claim to do	することを主張する
agree with	に賛成である
it is common to hear	を聞くのが一般的です
temple	お寺
heritage	遺産
abroad	外国で、外国へ
population	人口、国民
bring	持って来る、連れてくる
environmental	環境の
throw away	廃棄する
garbage	生ゴミ、くず
come up with	を思いつく、を考え出す
environmentally	環境的に
council	議会、会議
carry out	を成し遂げる
fuel	燃料
process	過程／を加工処理する
up to	～まで
turn into	に変わる
cut down on	を切り詰める、節約する
fossil fuel	化石燃料
ban	を禁止する／禁止
plastic bag	ビニール袋
harm	害／を害する
unbelievable	信じられない
innocent	罪のない、無罪の
arrogant	傲慢な、横柄な
harbor	港
temper	気性、かんしゃく
legend	伝説、言い伝え
fairly	かなり、公平に
vague	漠然とした、あいまいな
harvest	収穫／を収穫する
assistance	支援、手伝い
conflict	対立、争い
planet	惑星
ruin	を台無しにする、破滅する／破滅
launch	発売する、船をおろす
withdraw	を撤回する、引き下がる／引き出す
refuse	を拒否する、拒む
embrace	を抱きしめる、を抱擁する
overtake	追い越す
restrict	を制限する、を限定する
instruction	指示、指導
stock	株、在庫／を在庫に持つ
competitor	競合他社、競争相手
spectator	観客、見物人
explorer	冒険者、探検家
be filled with	で満たされている
due to	が原因で
remind of	を思い出させる
concentrate on	に集中する
laugh at	を見て笑う
well off	裕福な
straight on	まっすぐに
far off	はるかかなたの
equal	同等、等しい
drop off	落ちる、落とす
leave out	除外する、取り除く
the other	もう一方の
solve	を解決する
be concerned with	に関係している
childhood	子供時代
sustainable	存続可能な
leftover	残り物、食べ残し
at most	多くとも、せいぜい
because of	～のために
hundreds of	何百もの
efficiency	効率、能率
arrangement	配置、配列
treat	を扱う、待遇する
muscle	筋肉
aspect	局面、側面、表情
content	中身、内容、目次
prescription	処方、処方箋
anxious	心配して、不安な
ancient	古代の、大昔の
generously	惜しみなく、気前よく
literature	文学
do well	うまくやる
deadline	締め切り、期限
exception	例外
temporarily	一時的に、仮に
provide A with B	AにBを提供する
fund	基金、資金
in the long run	長い目で見れば、長期間に
accomplish	を成し遂げる、完成する
introduce	紹介する
overlap	重ねる
identify	を見分ける
collaboration	共同、共作、協力
detective	探偵、刑事
democracy	民主主義
modify	を変更する、を修正する
stir	をかき混ぜる
roll	転がる
orbit	軌道
frequently	頻繁に
emotionally	感情的に
evaluate	評価する、見積もる
defend	を守る、保護する
district	地域
purpose	目的、目標
prayer	祈り、礼拝
prospect	見込み、眺め
victim	犠牲者
distant	遠く離れた
various	様々な
visible	目に見える
wrap	を包む、巻きつける
dig	を掘る
drop by	ちょっと立ち寄る
take over	を引き継ぐ
angle	角度
payment	支払い
look into	を調べる
in practice	実際には
on schedule	予定通りに
once	かつて、1度
in fact	実際には
publisher	出版社
look forward to	～を楽しみにする
dizzy	めまいがする、ふらふらする
as though	まるで、あたかも
be pleased with	を喜ぶ
postpone	を延期する
justify	正当化する
fulfill	満たす
influence	影響／影響を及ぼす
capacity	容量
continent	大陸
industry	産業
surface	表面、水面
doubtfully	疑わしく
permanently	恒久的に、永久に
sensitive	敏感な
peaceful	平和な
medical	医学の
critics	評論家
explorers	探検家
obstacle	障害
admit	を認める、入ることを許す
react	反応する
succeed	成功する
disappear	消える、見えなくなる
take A for granted	Aを当然のことと思う
be familiar with	に馴染みがある
beyond	～を越えたところに
run away	逃げ去る
pass out	気絶する
think over	熟考する、よく考える
put away	片付ける、整理する
believe in	を信じる
calm down	落ち着く
what is worse	さらに悪いことには
observe	を観察する
participant	参加者
react to	に反応する、受け止める
at first	最初は
tight	狭い、締まった
be known for	で知られている
social	社会の
jealously	嫉妬深く
reliable	信頼性のある、あてになる
stable	安定した
transport	を輸送する
in other words	言い換えれば
associated with	と関連した、紐づいた
to start with	まず第一に、初めに
first of all	まず第一に
congratulations on	に対するお祝い、祝福
precious	貴重な、大切な
specialize in	に特化する、専門とする
vaccine	ワクチン
neverthless	にも関わらず
illness	病気
for free	無料で
checkup	健康診断、照合
temperature	温度、気温
health insurance	健康保険
memory loss	記憶喪失、記憶消失
inconvenience	不便、不自由
unusually	異常に、めったにないほど
take part in	に参加する
determine	を決める
be considered to	と見なされる
amount to	成る、達する
in some way	何らかの方法で
be connected to	に接続する
be involved in	に関与する
genetically	遺伝的に
diet	食事、食事療法
be made from	から作られる、を原料とする
major	専攻科目
sign	標識、印、合図
be threatened to	に脅かされる
progress	進歩、前進
with luck	運が良ければ
offensive	攻撃的な、無礼な
abrupt	突然の、不意の
familiar	見慣れた、よく知られた
distributor	卸売業者
publicity	宣伝、周知のこと
separation	分離
reuse	を再利用する、再使用する
strike	叩く、打つ
protest	抗議する、主張する
illustrate	を説明する、を例示する
voluntarily	自発的に、自ら進んで
consciously	意識的に、故意に
approximately	約、おおよそ
peacefully	平和的に、穏やかに
burden	負担、重荷
whistle	口笛を吹く
voyage	航海、航行
envy	妬み、羨望
exaggerate	を誇張する、大げさに言う
refer to	を参照する、参考にする
speaking of	と言えば
wait for	を待つ
in trouble	困った状況にある
at best	せいぜい、良くとも
except for	を除いては
matter	問題、困ったこと
in effect	効果のある、効いている
in fashion	流行っている、流行している
on demand	要求に応じて
individual	個人の、個々の
as well	同様に、その上
transportation	交通、輸送
in general	一般的に、普通
smell	においがする
recognize	承認する、はっきりと知る
get rid of	を取り除く
treatment	扱い、処理
expired	期限切れの、契約の切れた
fee	料金、手数料
current	現在の、現行の
renew	を更新する、新しくする
from now on	これから先も
attach to	に添える、に取り付ける
fill out	書き込む
unexpected	意外な、突然の
economic	経済の
breath	息、呼吸
carbon dioxide	二酸化炭素
humidity	湿度、湿気
on duty	勤務時間中で、当番の
in case	万一に備えて
gradually	次第に、だんだんに
ceiling	天井
out of use	すたれて、使用できない
sculpture	彫刻
exact	ちょうど、正確な
between A and B	AとBの間
produce	生産する、作り出す
even though	～だけれども、～であるのに
warm	暖かい、温暖な
inside	中身、内部
ill	病気で、気分の悪い
out of place	場違いで
research	研究／研究する
relative	相対的な、比較上の、親戚
poison	毒
completely	完全に、全く
be effective at	で効果的である
absorb	を吸収する
feed	餌を与える、育てる
effective	効果的な
container	容器
thanks to	のおかげで
on the run	逃げて、奔走して
dedicate	に専念する、奉納する
abandon	を捨て去る
amuse	楽しませる
range	範囲、幅
sphere	球、球体
revenge	に復讐する／復讐
popularity	人気、流行
suspicious	疑わしい、怪しい
delicate	繊細な、きめ細かい
welfare	福祉、幸福
border	国境
habit	習慣
interrupt	割り込む、中断する
persuade	を説得する
examine	を検査する
leisurely	のんびりした、気の長い
bravely	勇敢に、りっぱに
relatively	比較的
substitute	代わりに用いる／代用品
peel	皮
hospitality	おもてなし
tragedy	悲劇
struggle with	と闘う、に苦戦する
instruct	指示する、教える
gather	を集める
get used to	慣れる
out of date	時代遅れの
in tough	に強い
under way	進行中で
come into being	生まれ出る、生ずる
in need of	を必要として
be aware of	に気づいている
at a loss	途方に暮れて
within reach	届く範囲で
on average	平均して
in a row	一列に、連続的に
appear	現れる
hesitate	ためらう
be short of	が不足する
play a role in	において役割を果たす
alternative	代替物、代案
depression	落ち込み、不景気
large amount of	大量の、たくさんの
rug	じゅうたん、敷き物
invent	を発明する
encourage	を勇気づける、励ます
rarely	めったに～ない
digest	要約／消化する
focus on	に焦点を合わせる
be concerned about	について気をかける
vocabulary	単語、語彙
complex	複雑な、複合の
strengthen	強化する
similarly	同様に
ignorance	無知
opposite	反対の、向こう側の
pronunciation	発音
invention	発明
reverse	反対の、裏側の
commute	通勤する、取り替える
appeal	訴える、告発する
qualify	に資格を与える
incident	出来事、事件
market	市場
maximum	最大、最大の
yell	大声で叫ぶ
sneeze	くしゃみ
wipe	を拭く
twist	ねじれ、より合わせる
civilize	文明化する
murder	殺人
impose	を課す、負わせる
parliament	議会、国会
nursery school	保育園
glance	一目見る／一目
aid	援助／助ける
force	力、勢い
role	役割
acquaint	知人／に知らせる
superior	より優れた
knowledge	知識
mindful	気をつけて
stand still	停止、休止、行き詰まり
appearance	出現、外見
incredible	信じられない
in terms of	に関して、の点から
article	記事
for sure	確かに、間違いなく
ancestor	祖先、先祖
in time	丁度よい時に、丁度間に合って
bend	曲げる
occur	発生する、起こる
objection	異議、反対
lazy	怠け者の
outstanding	並外れた、目立った
construct	を組み立てる、建設する
adequate	適切で、十分な
instead of	の代わりに
mildly	穏やかに
scar	傷跡
hesitantly	躊躇して、もじもじして
wealthy	裕福な
give out	配布する、発表する
forget	を忘れる
stranger	他人
prove	を証明する
insurance	保険
generation	世代
take down	降ろす、書き取る
conclude	を締めくくる、終える
violence	暴力、乱暴
irritate	イライラさせる
put together	まとめる、一緒にする
account for	を説明する
tourism	観光
commit	専念、ゆだねる
put off	延期する
maintain	を維持する
favor	親切な行為
relevant to	に関連して
differ	異なる
keep up	保持する、維持する
look over	見渡す
though	だけれども
limb	手足
eventually	結局は、やがて
suggest	を提案する
entitle to	に資格を与える
capture	を捕まえる
psychology	心理学
export	を輸出する
spill	をこぼす
identity	同一性
participate	参加する
cough	咳払いする／咳
include	を含む
sincerely	心から、真心こめて
absorb in	吸収する、没頭する
improvement	改善、改良
crime	犯罪
spiritually	精神的に
proposal	提案
confess	を打ち明ける、白状する
credit	信用
reservation	予約
translation	翻訳
disadvantage	不利益、不利な立場
objectively	客観的に
consumption	消費、消費高
innocently	無邪気に
researcher	研究者、調査員
location	位置、場所
oxygen	酸素
do away with	廃止する
take care	注意する
neglect	を無視する、放っておく
be obliged to	義務付けられる、やむを得ずする
survive	生き残る
desert	砂漠
donation	寄贈、寄付
exhibit	示す、表す
principal	主要な
product	製品
in short	要するに
formal	形式の、形式的な
persuasion	説得
huge	巨大な、莫大な
migrate	移行する、移住する
logical	論理的な、論理上の
get away with	を持ち逃げする
interpret	を解釈する、受け取る
accuracy	正確さ、精密さ
contribution	寄付、貢献
climb	登る
stand up	立つ
preserve	保存／を保存する
laundry	洗濯物、クリーニング店
deal	を扱う、分配する
complain of	の不満を漏らす、について苦情を言う
intensive	集中的な、強調の
look through	をひと通り調べる、を見抜く
budget	予算、経費
mummy	ミイラ
dizziness	めまい
occasionally	時折、たまに
audience	聴衆、観客
liquid	液体
combine	を結合させる、合同する
imply	をほのめかす
applause	拍手かっさい、称賛
ridiculous	ばかげている
ignore	を無視する
mammal	哺乳類
indeed	実に、全く
blame for	の責任を問う、を責める
fossil	化石
obvious	明白な
precise	正確な、的確な
see in	案内して部屋に入れる、迎える
happen	起こる、発生する
argument	議論、口論
visually	視覚的に
terribly	ひどく、ものすごく
go after	を追いかける
by nature	本来、生来
direction	方向、方角
differ from	とは違って、との違い
astonish	ひどく驚かす、驚かせる
divide	を分割する、分ける
at least	少なくとも
distract	気を散らす、気をそらす
describe	を述べる、描写する
in place	決まった場所に、適切で
opinion	意見、考え
finally	ついに、やっと
frown	しかめっ面
culture	文化、教養
overcome	を克服する
figure	形、姿
inspire	鼓舞する
prize	賞
accomplishment	完成、成果
suburb	郊外
drag	引っ張る、引きずる
mineral	無機物
escape	逃れる、脱走する
come out	出てくる、世に出る
tremble	震える
stay up	（夜遅くまで）起きている
genuine	本物の、純粋な
come across	を横切る、出くわす
needlessly	不必要に
in exchange	と引き換えに
during	～の間、～の間ずっと
island	島
property	財産、所有物
deaf	耳が不自由な
masterpiece	傑作、名作
bound for	行きの、方向の
in stock	在庫あり
admission	入場、入場料
retire	退職する、引退する
deliver	配達する
draw	描く、引っ張る
factory	工場
create	創造する、考案する
rather	むしろ、どちらかといえば
threat	脅威
tropical	熱帯の
act on	を決定する、決議する
vital	極めて重要な、生命の
agricultural	農業の
altogether	完全に、まったく
quantity	量
male	男性、雄
by means of	によって、を用いて
insist	強く主張する
hesitation	ためらい、躊躇
persist in	固執する、やり通す
conversation	会話
ordinary	普通の、いつもの
in vain	無駄に、軽々しく
catch up with	に追いつく
off duty	非番の、勤務時間外で
live on	生き続ける
illustration	図解、実例
expensive	高価な、費用のかかる
expect	予期する、予想する
concentration	集中、専念
thermometer	温度計
advertisement	広告、宣伝
debt	借金、負債
pull down	引き下げる、取り壊す
investigate	調査する、研究する
description	説明書、記述
as follows	次のように
bother	面倒／迷惑をかける
punishment	罰、罰則
propose	を提案する、申し出る
flame	火炎、炎
ambulance	救急車
intense	激しい、熱心な
impossible	不可能な
be accustomed to	に慣れている
curiosity	好奇心
organization	組織、団体、協会
in danger of	の危険にさらされている
in turn	順番に
worthy of	ふさわしくて、に値して
look up to	を尊敬する
add to	付け加える、増やす
submit	を提出する、に服従する
immigration	移住、入国管理
convince	を納得させる
declare	を宣言する、公表する
vain	うぬぼれの強い
resource	資源、資産
domestic	国内の、家庭の
make up	用意する、片付ける
affection	愛情、好意
recent	最近の、新しい
discovery	発見
by heart	体で覚えて
stimulate	を刺激する、元気づける
college	大学
academically	学問的に
grass	草
praise	をほめる／賞賛
dentist	歯医者
truly	真に、正確に
cling	くっつく
clip	切る、切り取る／クリップ
reaction	反応
conventional	従来の
relieve	和らげる、軽減する
seek	求める、捜し出す
forever	永遠に
intervention	介在、仲裁
historian	歴史家
whether	どちらか
ethnic	民族の、民族特有の
swear	誓う
responsibility	責任
opponent	相手
blow	吹く
history	歴史
society	社会
mature	成熟した
democratic	民主主義の
manager	部長、支配人
definition	定義
abstract	抽象的な
recover	回復する
notion	考え、意見
reject	拒絶する、断る
chamber	小部屋
desire	願望／切望する
distinguish	を区別する
warn	警告する
excess	過剰、超過
numerous	多数の
harmony	調和
fail	失敗する
gentle	穏やかな、物柔らかな
enforcement	執行、実施
trait	特性、特色
deficit	赤字
source	情報源、原因
representative	代表者、代理人
commitment	約束、委託
worry	心配させる、心配する
bitter	苦い
assess	評価する
prosecution	起訴、告訴
discussion	議論、討論
drift	漂流
troop	群れ
crack	裂け目、ひび
plenty	たくさん
law	法律
share	分かち合う／分け前
assist	手伝う、促進する
later	後に
resolution	解決、決意
welcome	歓迎される
ensure	を確実にする、を保証する
classical	古典の
merely	単に
according	による、準じて
occupation	職業
proportion	比率、割合
anger	怒り
delivery	配達
annoy	いらだたせる
civilian	民間人、一般市民
craft	工芸、技能
appreciate	感謝する、を高く評価する
corridor	廊下
output	生産量
relation	関係性
pleasure	楽しみ、喜び
bored	退屈した
behavior	振る舞い、態度
conscious	意識して
objective	目標、目的地
education	教育
regional	地方の
controversial	議論の的になる、論争上の
investigator	捜査官
slide	滑る
seat	を着席させる／座席
tap	軽くたたく
manner	やり方、方法
therapy	治療
compete	競争する
representation	表現
tear	を引き裂く
crucial	重要な、決定的な
creative	創造的な
realize	だとわかる、実現する
physics	物理学
invest	に投資する
satisfaction	満足
dust	ほこり
possible	可能な
tremendous	非常に大きな
typically	典型的に
awareness	気づき
bill	請求書
quite	かなり
committee	委員会
dependent	依存している
especially	特に
deputy	代理
extent	程度、大きさ
subject	教科、主題
horror	恐怖
salary	給与
grand	壮大な
guide	案内人／案内する
vessel	容器
cooperation	協力
interfere	に干渉する
recall	呼び戻す、思い出す
patience	辛抱強さ
venture	冒険的事業
annual	毎年の
fair	公平な
behind	背後に
suppose	だと思う、と仮定する
provision	供給、支給
depend	依存する
myth	神話
sink	沈む
pregnant	妊娠している
derive	を引き出す
practically	実質的に、実際上
elaborate	手の込んだ
refugee	難民
motive	動機
ally	と同盟する
minimum	最小の
attorney	弁護士、代理人
commissioner	委員、理事
clue	手がかり、糸口
minister	大臣、牧師
arrival	到着
technical	技術上の、専門的な
similarity	類似点、相似
fully	十分に、完全に
nowhere	どこにも
reputation	評判
pretend	のふりをする
perception	知覚
rape	強姦する
lie	横たわる
tongue	言葉、舌
success	成功
install	導入する
hate	ひどく嫌う
notice	気づく／通知
mystery	神秘的な／神秘
adjust	を調節する
senate	上院
contemporary	現在の、現代の
previous	前の
oppose	反対する
arms	武器
creation	創造
Jewish	ユダヤ人
hunger	飢え、空腹
rude	失礼な
ritual	儀式
historical	歴史上の
opposition	反対、対立
structure	構造、建造物
percentage	割合
enter	入る
candidate	候補者、志願者
tip	先
use up	使い切る
state	状態
dignity	威厳、尊厳
physician	医師、内科医
labor	労働、労働者
international	国際的な
fiber	繊維
strongly	強く、激しく
household	家族、世帯
nation	国家
jury	陪審員
former	前の
illegal	違法の
circumstance	状況、環境
wan	青ざめた
spoil	台無しにする、損なう
composition	構成、制作
tail	尾
majority	大多数
beside	の横に
operation	操作、作用
talent	才能
pleasant	楽しい
era	時代
ultimate	究極の、最後の
telescope	望遠鏡
originate	始まる、起こす
delight	喜び、歓喜
afford	余裕がある
operate	操作する
consistent	一貫した、矛盾のない
exhaust	疲れ果てさせる、消耗させる
twin	ふたご
smart	頭の良い、きちんとした
enhance	強調する、（さらに）高める
defendant	被告人
negotiation	交渉、話し合い
face	直面する／顔
immediate	即座の
instant	瞬間、瞬時
bloody	血の
gear	伝動装置
block	を妨げる
unless	でない限り
willing	いとわない、快諾する
negotiate	交渉する
doubt	疑い、疑問
whenever	する時はいつでも
wage	賃金
abortion	中絶
strange	奇妙な、異常な
estate	財産
addition	追加
fix	固定する
bind	縛りつける、束ねる
shed	流す
citizen	市民、国民
summit	頂上
battery	電池
complexity	複雑さ
reduction	削減、減少
disaster	災害、災難
comfort	快適さ／慰める
founder	創設者
assault	暴行、攻撃
broadcast	放送する
critic	批評家、評論家
friendly	友好的な、親切な
consequently	その結果として
unable	できない
urban	都会の
detailed	詳細の
primitive	原始的な
electrical	電気の、電気を用いた
afraid	心配して、恐れて
community	共同社会
connect	つなげる
scheme	計画、案
language	言語
colleague	同僚、仲間
stroke	打撃
servant	使用人、召使
belief	信念
inflation	膨張
Muslim	イスラム教徒
upset	気持ちが動揺した、ひっくり返す
permanent	永久の
apply	適用する
failure	失敗
seed	種子
potentially	潜在的に
cultivate	耕作する
awful	ひどい、恐ろしい
mate	友達、仲間
military	軍隊の
armed	武装した
lung	肺
sequence	連続
impress	感銘を与える
Mexican	メキシコの
suffering	苦しみ
refrain from	を控える、を遠慮する
well-known	よく知られた、有名な
associate	結びつけて考える、賛同する
lord	領主、支配者
governor	知事
inquiry	問い合わせ、質問
bishop	司教
background	背景
beg	懇願する
relevant	関連のある、適切な
recognition	認識
sharp	鋭い
legal	法律の
criticize	を批評する
naked	裸の
symptom	症状
raw	生の
association	協会、連合
phase	段階
politics	政治
atmosphere	雰囲気
lap	ひざ
clerk	事務員、社員
fault	欠点、短所
toward	に向かって、の方へ
foreign	外国の
global	地球の
hire	雇う
item	項目、品目
dislike	嫌がる、嫌い
unknown	未知の
nearby	近くの
traditional	伝統的な
liberty	自由、独立
toe	つま先、足の指
mean	を意味する
appoint	任命する、指定する
courage	勇気
quarter	四半期
affair	事柄
snap	パチンと鳴らす
tale	お話
educational	教育の
hardly	ほとんどない
conclusion	結論
whereas	である一方で
custom	習慣
biological	生物学上の
confine	制限する
beneath	の下に
extinction	絶滅
tiny	ごく小さい
election	選挙
charm	魅力
palm	手のひら
log	丸太
advertise	宣伝する、広告する
advertising	広告
factor	要因
curious	好奇心が強い
pitch	投げる
excessive	過度の、極端な
war	戦争
apparently	明らかに
boundary	境界
procedure	手続き、手順
consumer	消費者
satisfactory	満足のいく
echo	こだま
essay	論文、小説
extension	拡張、延長
atomic	原子の
sigh	ため息をつく
sophisticated	洗練された
considerable	かなりの、重要な
explain	を説明する
bet	賭ける
plant	植物
scatter	まき散らす
largely	主として
rear	後部の
bond	拘束、束縛
authority	権威、権力
medium	中間
adapt	に適合させる
resist	抵抗する
folk	人々
poet	詩人
resolve	解決する、を決心する
detail	詳細
priority	優先度、優先権
false	誤った
prisoner	囚人
apparent	外見上の、明白な
lab	研究室
squeeze	絞る、押しつぶす
status	状態、身分
pension	年金
eliminate	を取り除く
patch	当て布、布切れ
observation	観察
dozen	12の
airline	航空会社
flow	流れる
independent	独立した
president	社長、大統領
socially	社会的に
settle	決着させる、解決する
ideal	理想
address	住所
pray	祈る
ray	光線、放射線
maker	製造元
combat	戦闘
ministry	省庁
explosion	爆発
cure	治療する
public	公共の
reach	到着する
impact	影響、衝撃
union	統合、一致
author	著者
presence	存在
incorporate	合体させる
rent	家賃
radical	急進的な、抜本的な
economics	経済学
trust	信頼、信用
virus	ウイルス
party	政党
pupil	生徒
neighborhood	近所
concern	心配する、に関係する
meal	食事
neighbor	隣人
civil	市民の
counter	に対抗する
suicide	自殺
protein	タンパク質
poll	投票
mutual	相互の
vote	投票する／投票権
attend	出席する、付き添う
regret	後悔する／後悔、遺憾
academic	学術の、大学の
supreme	最高の
comfortable	心地の良い、快適な
involvement	関与、関わり合い
crowd	群衆
emotional	感情の、情緒の
revenue	収益、所得
quit	やめる
unusual	珍しい、異常な
remember	覚えている、を思い出す
guilty	有罪の
fascinate	魅了する
trigger	引き金
distinction	区別、相違
transform	を変える
transfer	を移す
order	命令
hide	隠す、隠れる
solid	固い、固形の
plain	簡素な、わかりやすい
ease	容易さ、気楽さ
stretch	広がる
amendment	修正
frighten	怖がらせる
heel	かかと
perceive	知覚する
rational	理性的な、合理的な
faith	信頼、信用
conviction	信念
agent	代理人
rural	田舎の
pioneer	開拓者
humanity	人間、人間性
within	以内で
respect	尊敬
sweep	掃く
display	展示する、陳列する
own	自身の
hang	つるす、掛ける
transition	遷移、変遷
decision	決定、結論
aware	気づいている、知っている
reward	褒美、報酬
uncomfortable	心地が悪い
civilized	発達した文明をもつ、教養の高い
aggressive	攻撃的な
infant	乳児
means	手段、方法
useless	役に立たない、むだな
briefly	簡単に、手短に
site	場所
nature	自然
dialect	方言
genius	天才
conduct	行為
demonstrate	実証する、証明する
disappoint	がっかりさせる
circuit	回路、巡回
regime	政権
awake	目を覚ましている
useful	役に立つ
entertainment	娯楽
express	表現する、を言い表す
sacrifice	犠牲
devise	考え出す、工夫する
intimate	親密な
seldom	めったに～しない
criticism	批判
price	値段
insect	昆虫
painful	苦痛な、痛い
invisible	見えない
present	現在の、出席して
somehow	どうにか
agreement	同意
although	だけれども
advocate	提唱する
govern	統治する
inspector	検査官、監査人
essentially	本質的に
severe	厳しい、厳格な
convenient	都合が良い、便利な
due	期限の、納期の
coast	海岸、沿岸地域
extreme	極端な
relief	安堵、軽減
edge	端縁
vice	副担当の、代理の
national	国の、国民の
vulnerable	傷つきやすい
evolution	進化、発展
slight	かすかな、わずかの
rely	頼る
globe	地球
plot	話の筋、策略
prompt	即座の
electronic	電子の
advice	助言
industrialize	産業化する
select	を選び出す
carbon	炭素
sudden	突然の
deliberately	故意に、慎重に
significant	重要な
employ	雇う
latest	最新の
tough	頑強な、丈夫な
tide	潮
asset	資産
origin	起源
popular	人気のある
colony	植民地
distribution	分布、配分
constitution	憲法、構成、組織
increasingly	ますます
necessarily	必然的に
restriction	制限
drug	麻薬、薬
rapid	急速な
possibly	ひょっとすると
mortgage	抵当、担保
complain	不満を言う
county	州
supporter	支援者
federal	連邦の
fur	毛皮
commercial	商業の
aggression	攻撃性、侵略
entire	全体の、全部の
odd	変な
basis	土台、根拠
protect	を守る、保護する
confirm	確認する、確かめる
broad	広い
prior	優先の、前の
consequence	結果、影響
pretty	かなり
manufacturer	製造元、製造業者
exhibition	展示
cruise	巡航する
extraordinary	普通でない、異常な
leisure	余暇
multiple	掛け算する
variation	変化
suit	適合する
teenager	十代
bare	裸の
minority	少数派
rapidly	素早く
brick	れんが
lawn	芝生
consist	成り立つ
duty	職務、関税
period	期間
comprehensive	包括的な、理解力のある
achievement	達成
sum	合計
seem	の様に見える、思われる
implement	実施する／道具、手段
interior	内部の
calculate	計算する
dominate	を支配する
obligation	義務
joy	喜び、歓喜
throat	のど
imagination	想像
democrat	民主主義者
chapter	章、区切り
hell	地獄
lean	傾く、寄りかかる
pan	フライパン
blast	爆風、突風
exist	存在する、実在する
politician	政治家
industrial	産業の
merchant	商人
focus	焦点
actual	現実の
urge	強く促す、早める
nerve	神経
mostly	主に、ほとんど
criminal	犯罪の
passage	一節
logic	論理
arise	起こる、現れる
whatever	何でも
rebel	反逆者
encounter	遭遇する
depress	落胆させる
widely	広範囲に
expansion	拡張、拡大
existence	存在
peculiar	奇妙な、変わった
strict	厳しい、厳格な
firm	しっかりした、堅い
desperate	やけくその
sort	種類
personally	個人的に、本人自ら
universe	宇宙
blood	血、血液
institution	制度、設立
facility	施設、手洗い、便利さ
crew	乗組員
index	索引
unpleasant	不愉快な
etc	などなど
elementary	初級の
viewer	観察者、視聴者
spiritual	精神の
conference	会議
freeze	凍る
debate	討論
swallow	を飲み込む
convey	伝える、運ぶ
honor	名誉、特権
traffic jam	交通渋滞
concrete	具体的な
laboratory	実験室、研究所
capable	可能性がある、才能のある
treasure	宝、財産
reserve	を取っておく
phenomenon	現象
chest	たんす、チェスト
bite	を噛む、かじる
crop	収穫物、作物
rub	こする、さする
shortly	まもなく
term	期間、専門用語
distance	距離
right	正しい
inclined	傾いた、（し）がちで
attract	引きつける
headquarters	本部
highlight	目立たせる、最も明るい部分
owe	を借りている
accustomed	慣れている、いつもの
portion	部分、一部分
mad	狂った
buyer	買い手
till	まで
destruction	破壊
injury	怪我、負傷
confusion	混乱
employer	雇用者
proper	適切な、ふさわしい
nervous	神経質な、びくびくして
companion	仲間
psychological	心理的な
impression	印象
confront	直面させる、に立ち向かう
path	小道
suppress	抑える、抑圧する
decline	断る、拒否する
truth	真実
intellectual	知的な
jail	刑務所、拘置所
cease	やめる
pile	積み重ね
cover	を覆う、隠す
finance	財政
cast	投げる
distinct	他と違った、別の
conservation	保全
prosecutor	検察官
initially	最初は
behalf	代わって、誰かの代わりに
region	地域
prefer	より好む
perspective	見解、見通し
income	所得
identical	同一の、全く同じの
impressive	印象的な
polite	礼儀正しい
executive	実行する
rough	ごつごつした、粗い
proposed	提案した
province	州
seize	つかむ
personality	人格、性格
stake	くい
goal	目標、ゴール
girlfriend	女友達
forward	前方へ
narrow	幅が狭い
shortage	不足、欠乏
apart	離れて
emphasis	強調
shooting	撮影、射撃
inhabitant	居住者
recession	不況、後退
passive	受身の、消極的な
subtle	微妙な
competitive	競争力のある、競争による
clothing	衣料品
wise	賢い
pursuit	追跡
settlement	移住定住
partnership	共同、提携
expression	表現
dispute	争議／論争する
contrary	反対の
expand	拡大する、広がる
intelligence	知能、知性
divorce	離婚／離婚する
compound	調合する
defeat	負かす、打ち破る
assumption	想定、仮説
sustain	保持する、続けてする
initiative	主導権、独創力
bow	お辞儀する
examination	試験
confidence	自信、信頼
yield	産出する、生ずる
firmly	堅く、確固として
engaged	に従事して、忙しくして
impulse	衝動
destroy	を破壊する
steady	着実な、安定した
element	要素、元素
dealer	販売業者
mysterious	不可解な、不思議な
comparison	比較
communist	共産主義者
republic	共和国
expose	明らかにする
department	部門
explanation	説明
isolate	を孤立させる、隔離する
proceed	進む、始める
explore	探索する、調査する
regarding	に関して
stupid	馬鹿な、愚かな
alive	生きている
dramatic	劇的な
potential	潜在的な
approval	承認
dare	思い切ってする
activist	行動主義者
effectively	効果的に、事実上
strain	張る
guess	推測する
cash	現金
asleep	眠っている
mass	塊、大部分
latter	後者の、後半の
absolutely	絶対に
intention	意図
science	科学
split	割る、裂く
diminish	減らす、小さくする
positive	自信のある
remote	遠い
collect	集める
equivalent	等しい
bear	我慢する、を圧迫する
empire	帝国
several	幾つかの
navy	海軍
significance	重要性
practical	実用的な
shame	恥
agriculture	農業
leap	跳ぶ、はねる
empty	何も入っていない
insight	洞察、洞察力
verbal	言葉の
unit	単位
evil	邪悪な
newly	新たに、最近
automobile	自動車
university	大学
publication	出版物
past	過去の、終わった
contrast	対照
weather	天候、天気
lack	不足、欠乏
brief	短い、短時間の
cop	警官
eager	強く望んでいる
crown	王冠
observer	観察者
nod	うなずく、会釈する
investment	投資、出資
scientific	科学の
constitute	構成する
moral	道徳の、道徳的な
voter	投票者
remarkable	目立った
mere	単なる
belong	に属する
pursuit	追い求める、追跡する
totally	完全に、全く
patient	我慢強い、患者
match	試合
laughter	笑い
survival	生存
fellow	仲間
towards	の方へ
aircraft	航空機
legislation	立法
wherever	どこでも
tax	税金
nuclear	核の
internal	内部の
enterprise	会社、事業
initial	最初の
division	分割
parallel	平行の
preference	好み
consideration	考慮、考察
expectation	期待、予想
literally	文字通りに
grave	墓
immigrant	移民
found	設立する
terror	恐怖
suitable	好都合な
reference	参照
fabric	織物
length	長さ
deny	を否定する
satellite	衛星
steadily	着実に
fundamental	基本的な、基礎の
strategy	戦略
virtually	実質的に
partly	部分的に
grasp	つかむ
undergo	経験する
congress	会議
given	与えられた
traffic	交通、運輸
mainly	主に、もっぱら
cave	ほら穴
fancy	空想、想像
wisdom	知恵、賢明さ
blink	瞬きをする
scholar	学者
rid	を取り除く
privilege	特権
method	方法
establishment	設立
shrug	肩をすくめる
aloud	声に出して
continue	をし続ける
master	主人、支配人
rating	評価
profession	職業
flee	逃げる
administration	機関、運営
die	死ぬ
throughout	至るところに、終始
shit	大便
tradition	伝統
typical	典型的な
weigh	重さがある、の重さを量る
unlikely	起こりそうにない
weight	重さ、体重
normally	通常は、普通に
retain	保持する、持ち続ける
overwhelming	圧倒的な
promotion	昇進、進級
massive	巨大な、大規模な
desirable	望ましい
stare	じっと見つめる
application	適用
extra	余分の、特別の
fat	太った
gene	遺伝子
contract	契約
recovery	回復
court	裁判所、中庭
analysis	分析
peer	同僚、仲間
regardless	にも関わらず、不注意で
fire	首にする、火をつける／火、火事
entitle	と題する、権利を与える
secretary	秘書
pit	くぼみ
critical	極めて重要な、批判的な
crisis	危機、難局
flood	洪水
wildlife	野生動物
wrong	間違い、誤った
wear	身につけている
earn	稼ぐ
import	輸入する
retirement	退職、引退
stream	流れ
species	種、種族
discuss	について議論する、検討する
coalition	連立、連合
generate	発生させる、起こす
alter	を変える
absolute	絶対的な、完全な
bury	埋める
deserve	値する
contribute	に寄付する、捧げる
implication	含み、裏の意味
calm	穏やかな、静かな
constantly	常に
famous	有名な
precisely	正確に
parking	駐車場
ad	広告
commander	司令官
rise	上がる
gain	得る
proud	自慢に思って、誇らしげな
lose	失う
editor	編集者
killer	殺人者
material	材料、原料
breast	胸部
appetite	食欲
flavor	風味、味
aim	ねらいをつける
preparation	準備
investigation	調査
storage	保管
investor	投資家
whole	全部の
regulation	規制、規定
existing	既存の
fate	運命、宿命
accuse	告発する
cope	対処する
racial	人種の、民族の
judge	を判断する／裁判官
disagree	反対する
release	解き放つ
literary	文学の
maybe	たぶん、おそらく
alliance	同盟、協定
thought	考えること、意見
comedy	喜劇
reply	返答する
gay	同性愛の
definite	明確な、限定的な
attempt	試み
commission	手数料、委任状
except	を除いて
height	高さ
favorite	特に好きな
harmful	有害な
object	物体
dull	面白みのない、鈍い
context	文脈
fold	折りたたむ
suggestion	提案
steam	蒸気、水蒸気
extensive	広範な
mayor	市長、町長
funding	資金調達
operator	操作者
universal	普遍的な、万能の
exposure	暴露、さらすこと
pose	姿勢、ポーズ
headline	見出し、表題
bang	ドンドン叩く／ズドンという音
likely	起こりそうな
necessity	必要性
financial	財政の
resistance	抵抗
grammar	文法
capital	資本、首都
intend	意図する
alike	よく似た
passenger	乗客
peak	頂上
educate	教育する、訓練する
closely	綿密に
exactly	正確に
moment	瞬間、瞬時
extend	延びる、延長する
employee	従業員
remaining	残りの
negative	否定の
acknowledge	を認める
burst	破裂する
portrait	肖像画
possibility	可能性、実現性
absence	不在、欠席
primary	最初の
inferior	劣った
interpretation	解釈、説明
evident	明らかな
tribe	部族
maintenance	維持、保全
female	雌の、女性の
depending	依存している
so-called	いわゆる
accept	受け入れる
enthusiasm	情熱、熱狂
joint	継目、関節
assessment	評価、査定
evolve	進化する
occupy	占める
mention	言及する
profound	深い、心からの
significantly	かなり
agree	同意する
assure	保証する
dump	投げ捨てる
difference	違い、差分
coal	石炭
drain	排出させる、排水をする
suspect	疑う、だと思う
gaze	凝視する
sure	確信して、自信をもって
steel	鋼鉄
exclude	除く
surgery	手術、外科
add	足し算する、合計する
load	積む／積み荷
inevitable	避けられない
account	銀行口座
as a matter of fact	実際のところ
commodity	商品
grace	恵み
distort	歪める
arctic	北極地方
obsession	強迫観念
obey	従う
rule out	除外する
manipulate	操る
sue	訴える
get rid of	を取り除く
Buddhist	仏教徒
as far as I know	私の知る限り
put off	延期する
extract	抜き取る
as if	まるで～かのように
indigenous	原産の
slavery	奴隷制度
avenue	大通り
destination	目的地、行き先
designate	選定する
domain	領地
result in	結果として、結果～になる
infrastructure	基盤
provoke	挑発する
sole	単独の
convict	有罪とする
apply for	を申し込む
fatigue	疲労
precede	先行する
decent	まともな
utter	完全な
look over	見渡す
stern	厳格な
breed	を飼育する、繁殖する
no longer	もはや～でない
one by one	一つずつ、一つ一つ
forecast	予測する
evidence	証拠
otherwise	さもなければ
require	を必要とする、を要求する
architect	建築家
lessen	減らす
tumor	腫瘍
dormitory	寮、大部屋
suffer from	で苦しむ、悩まされる
thrust	突き上げる
handout	配布物
addicted	癖になった
kindergarten	幼稚園
reasonable	理性のある、分別のある
phenomenon	現象
accommodate	収容する
obscure	不明瞭な
resign	辞任する
grocery	食料品
prejudice	先入観
souvenir	お土産
bring up	持ち出す
supervisor	上司
transaction	取引
attribute	に帰する
stiff	硬い
put up with	に耐える
induce	誘発する
withstand	耐える
penetrate	貫く
fraction	分数
conceal	隠す
retail	小売り
isolation	隔離
before long	間もなく
biology	生物学
in terms of	に関して、の点から
aisle	通路
due to	が原因で
toll	料金
struggle	もがき苦しむ
subsequent	その後の
soak	浸す
deal with	に対処する
supplement	補足、追加
drought	干ばつ
rely on	に頼る、を当てにする
sanitation	衛生
conform	従う
at most	多くとも、せいぜい
scarce	乏しい
trivial	取るに足らない
thorough	徹底した
urge	強く促す、早める
predator	捕食者
beverage	飲料
emperor	皇帝、天皇
soar	舞い上がる
embarrassed	恥ずかしい
and so on	などなど
famine	食料不足
secondhand	中古の
bureau	事務局、たんす
extinct	絶滅した
on duty	勤務時間中で、当番の
roast	あぶり焼きにする
along with	に沿って
make fun of	を笑いものにする
conquer	征服する
come up with	を思いつく、を考え出す
converse	逆の
revise	改訂する
lawyer	弁護士、法律家
dip	少し浸す
look into	を調べる
optimistic	楽観的な
neat	きちんとした
refer	言及する
expire	期限切れの
imperial	帝国の
hierarchy	階層
erosion	侵食
evoke	呼び起こす
chemistry	化学
habit	習慣、慣習
vanish	消える
medieval	中世の
earnest	真剣な
get by	どうにか切り抜ける
cope with	に対処する
savage	獰猛な
spur	刺激
bleed	出血する
eyesight	視界
apologize	謝る、謝罪する
concentrate	集中する
utilize	利用する
fame	名声
accommodation	宿泊施設
donate	を寄付する、を寄贈する
starve	飢える
in spite of	にも関わらず
organ	臓器
domestic	国内の、自国の
discrimination	差別／差別的な
bully	いじめっ子
bake	焼く、焼成する
ambiguous	あいまいな
integrate	統合する
particle	分子
magnificent	壮大な
pastime	娯楽
enrich	豊かにする
refund	払い戻す
germ	細菌
rumor	うわさ
run out of	を使い果たす、消耗する
descend	下降する
irrelevant	無関係な
endow	寄付する
fingerprint	指紋
vending machine	自動販売機
compile	編集する
compassion	思いやり
ancestor	祖先、先祖
in case	万一に備えて
think over	熟考する、よく考える
according to	によれば、に基づいて
by degrees	徐々に
sorrow	悲しみ
approve	承認する
undertake	引き受ける
compliment	褒め言葉
hang up	中断する
overwhelm	圧倒する
confess	を打ち明ける、白状する
break out	勃発する
watch out	気を付ける
pull off	もぎ取る、成功を掴む
awkward	ぎこちない
tame	飼いならす
appropriate	適当な、充当する
try on	試着する
adolescent	思春期の
carry out	を成し遂げる
ambition	野望
scholarship	奨学金
get along with	とうまくやっていく
come across	を横切る、出くわす
remain	のままである、残る
emotion	感情、情熱
emergency	緊急事態、緊急
spouse	配偶者
call off	を中止する
be willing to	する気のある
shrink	縮小する
molecule	分子
document	書類
nap	昼寝
instead of	のかわりに
assemble	組み立てる
injection	注射、注入
endanger	危険にさらす
basin	盆地
suspend	つるす
stem	幹
hand in	を提出する
be engaged in	に従事している
burden	負担、重荷
a couple of	少数の
be well off	裕福な
outcome	結果
retrieve	取り戻す
in shape	健康に
make sense	意味をなす
tidy	きちんとした
reveal	明らかにする
consist of	から成り立っている
afterwards	その後
even if	たとえ～だとしても、仮に～であっても
sewage	下水
abolish	廃止する
ugly	醜い
get over	を乗り越える、克服する
modest	控えめな
bloom	咲く
holy	神聖な、聖なる
assign	割り当てる
architecture	建築
sparkle	きらめき
How come	どうして～
at times	時々
fragment	断片
fare	運賃
prey	獲物
devastate	荒廃させる
show up	現れる
in contrast to	とは対照的に
nutrition	栄養、栄養素
low-income	低収入の
leak	漏れる
exert	行使する
protocol	儀礼
toxic	有毒な
documentary	事実を記録した
acute	鋭角の
prohibit	禁じる
equality	平等さ
organic	無農薬の
formula	式
exclusive	閉鎖的な
sincere	誠実な
vow	誓い
in charge of	の担当をして
intuition	直感
laptop	ノートパソコン
outstanding	並外れた、目立った
tissue	細胞組織、薄い織物
by means of	によって、を用いて
layer	層
sit up	まっすぐ座る
explode	爆発する、破裂する、激増する
irrigation	灌漑
refrain from	を控える、を遠慮する
a bunch of	たくさんの、多量の
altitude	高度
humid	湿っぽい、湿度の高い
hemisphere	半球
salty	塩辛い
custom	習慣、慣習
award	賞
billion	10億
ashamed	恥じて、恥ずかしくて
definitely	もちろん、確かに
do away with	廃止する
litter	ゴミ
stare at	をじっと見つめる
invade	侵略する
beat	打ち負かす
stubborn	頑固な
settle down	定住する
harsh	厳しい
prolong	延長する
humble	謙虚な
reinforce	強化する
fragile	もろい
refuge	避難
cut down	を減らす、削減する
bold	勇敢な
breeze	そよ風
lately	最近
tuition	授業料、学費
indicate	指し示す
vivid	鮮やかな
out of stock	在庫切れ
comprehend	理解する
accumulate	蓄積する
summon	召喚する
acquire	を身につける
pedestrian	歩行者
restrain	抑える