replaceable	置き換えられる、代わりのある
spark	火花、きらめき
pity	同情、哀れみ
strictly	厳密に、厳しく
brightly	明るく、輝いて
hang on	しがみつく、頑張る
look up to	を尊敬する
sympathetic	思いやりのある、共感的な
end up	最終的に～することになる
chimney	煙突
temper	気性、かんしゃく
quarrel	口論、口げんか
bark	吠える／木の皮
loyalty	忠誠、誠実
intent	意図、目的
lately	最近、近ごろ
invade	に侵入する、を侵略する
tender	優しい／世話人
map out	綿密に計画する、詳細に計画する、地図に精密に示す
spontaneous	自発的な、任意の
forgive	を許す、大目に見る
in contrast	対照的に、これに対して
fame	名声、高名
modest	控えめな、謙虚な
thumb	親指
robber	強盗、強盗罪
terribly	ひどく、ものすごく
drawer	引き出し
informal	非公式な、略式の
conclusive	決定的な、結論的な
fertilizer	肥料、化学肥料
holistic	全体論の、総体的な
sincerely	心から、真心こめて
sympathy	同情、共感
pat	軽くたたく、軽く打つ
in order to	～するために
pioneer	開拓者、先駆者
mend	を直す、修繕する
pollution	汚染、汚れ、汚染物
tightly	しっかりと、きつく
cruel	残酷な、無慈悲な
oxygen	酸素
come down with	病気などにかかる、罹患する
applause	拍手、賞賛
spectator	見物人、観客
afford to	する余裕がある
slave	奴隷
debt	借金、負債
tame	人に慣れた／飼いならす
blank	白紙の、空白の
gross	全体の、総体的な
meantime	合間に、その間に
impractical	非実用的な、実行不可能な
sturdy	たくましい、頑強な
confess	を告白する、白状する
silence	沈黙、静けさ
incredible	信じられない、信じがたい
nasty	不快な、不愉快な
envelope	封筒
ugly	醜い、見苦しい
do away with	を廃止する、除く
horrible	恐ろしい
leap in	飛び込む、急上昇する
soap	石鹸
spite	悪意、恨み
reception	応接、歓迎
noble	気高い、高貴な
capacity	容量、容積
blend	を混ぜ合わせる、を混ぜる
tuck in	押し込む、詰め込む
religious	宗教上の、信仰の
laundry	洗濯物、クリーニング店
interval	間隔、合い間
rob	から奪う、強奪する
vast	広大な、莫大な
luggage	荷物、手荷物
grief	悲しみ、深い悲しみ
kettle	やかん、湯沸かし
flock	群れ、集団
fall for	に夢中になる、騙される、引きつけられる
intend to	するように意図する
adventure	冒険
cart	荷車、荷馬車
earthquake	地震
grace	優雅さ、洗練
shell	貝殻、貝
weave	織物を織る
boast	自慢する、誇示する
knock down	を取り壊す、打ち倒す
bandage	包帯、絆創膏、ガーゼ
afterward	その後
instruct	に教える、知らせる
starve	飢える、餓死する
horizon	地平線、水平線
arrest	を逮捕する、検挙する
lay off	を解雇する、首にする
prestigious	著名な、名声のある
geography	地理、地理学
per	につき、ごとに
at face value	額面通り、表面通りの価値で
act up	あばれる、騒ぐ
beggar	乞食、物乞い
warmth	暖かさ、温もり
stabilize	固定させる、安定させる
meadow	牧草地、草原
water down	水で薄める、和らげる
fountain	噴水、泉
phase out	段階的に廃止する、撤去する
thin	薄い、痩せた
replacement	交換、置き換わり
cage	かご、おり
get past	のそばを通る、通り抜ける
what is more	さらに、その上
invitation	招待、案内
container	容器、入れ物
jealous	うらやましい、嫉妬している
marble	大理石、大理石模様
tutor	家庭教師、個別指導者
unite	を結合させる、団結する
in substance	実質上、実際には、事実上
comb	くし
fiction	創作、作り話
in the red	赤字で、赤字経営で
frank	率直な、隠さない
spectacle	光景、ありさま
eager to	したがる、熱意を持って
shed light on	に光を放つ、当てる
fanatical	熱狂的な、熱烈な
glue	接着剤
bold	勇敢な
ultimately	最後に、ついに
backyard	裏庭
roast	あぶり焼き、直火で焼くことにする
neat	きちんとした、整った
put up at	に泊まる、宿泊する
set a precedent	先例を作る、前例を作る
flash	閃光
organ	臓器、器官
kingdom	王国
outstanding	目立った、顕著な
rise and shine	起き上がる、起床する
vague	漠然とした、はっきりしない
break into tears	涙が出る、泣き出す
ankle	足首
instead	代わりに、それよりも
striking	印象的な、目立つ
harsh	厳しい、過酷な
vandalize	わざと壊す、故意に破壊する
essence	本質、真髄
pull over	車を止める、車を停止させる
calmly	落ち着いて、静かに
fortunately	運よく、幸いにも
countryside	田舎、地方
vanish	見えなくなる、消える
be akin to	に似ている、と同種である
atom	原子、微小分子
rage	激怒、憤慨
sincere	誠実な、真剣な
elder	年上の、年長の
convention	大会、会議
urgent	緊急の、急を要する
rough up	手荒く扱う、かき乱す
glorify	栄光をたたえる、賛美する
stair	階段
atlas	地図帳
invention	発明
be incongruous with	と矛盾する、と不一致である
delighted	うれしい、喜んだ
go astray	行方不明になる、堕落する
wrap	を巻き付ける、包む
shallow	浅い
bush	茂み、低木
stiff	硬い
discern	はっきり分かる、認める
seclusion	隔離、分離
discharge	排出、放電／荷を降ろす
progression	前進、進歩
wheat	小麦
weary	疲れた、疲弊した
purse	財布、ハンドバッグ
blame	非難する、咎める
employment	雇用、採用
result in	結果として～になる
fare	運賃、料金
venue	会場、場所
archaeological	考古学の、古典的な
stumbling block	障害、障害物
chill	冷たさ、寒気
distribute	を配布する、分配する
breeze	そよ風、微風
parcel	小包、包み
sew up	縫合する、縫い合わせる
prop up	添える、支える
fall back on	に頼る、信じる
weed	雑草、草取り
bless	を祝福する、に授ける
specialize in	を専門にする、に特化する
headache	頭痛
feather	羽根、羽毛
electricity	電気、電流
ladder	はしご、踏み台
freezer	冷凍庫
dawn	夜明け、暁
filament	細糸、線条
be prone to	する傾向がある、しがちである
injure	を傷つける
end up with	で終わる、の羽目になる
weep	泣く、涙を流す
peasant	農民、農夫
baggage	荷物、手荷物
deliberate	故の、意図的な
break up	別れる
endless	無限の、果てしない
pessimism	悲観的、悲観主義
give off	を放つ、放出する
contend with	と戦う、張り合う
bore	退屈させる、うんざりさせる
instance	衝動、例
villain	悪党、悪者
miserly	しみったれた、欲深い
disappointment	失望、期待外れ
peel away	むく、剥がす
under fire	攻撃を受けて、批判を受けて
complicated	複雑な、込み入った
no longer	もはやない
wrist	手首、そで口
pay regard to	を尊重する、尊敬する
apology	謝罪、言い訳
refrigerator	冷蔵庫、冷却装置
keep at	を根気よく続ける、継続する
suck	を吸う、すする
breed	繁殖する、子を産む
cut off	を断つ、切る
anyhow	どうしても、なんとしても
monastery	修道院
bound	跳ねる、跳ね返る
opt for	選ぶ、選択する
turn over	をひっくり返す
tendency	傾向
get by	どうにか切り抜ける、何とか乗り越える
departure	出発
devote	に捧げる、ゆだねる
tuition fee	授業料、学費
beard	ひげ、あごひげ
weed out	取り除く、引き抜く
intimacy	親密さ、親交関係
mockingly	あざけるように、からかって
fortunate	幸運な、運の良い
offensive	不快な、いやな
inopportune	間の悪い、都合の悪い
in response to	に応じて、に反応して
scoop up	すくい取る、くみ上げる
stand down	身を引く、後退する
rub in	刷り込む、繰り返し言う
steep	急勾配の、傾斜の急な
screw	ねじ
see out	見送る、見届ける
moustache	口ひげ
revolution	革命
technological	技術的な、科学技術の
loyal	忠実な、信念の厳格な
fall apart	崩壊する、ばらばらに壊れる
flour	小麦粉
vase	花瓶、つぼ
grain	穀物、穀類
crush	を押しつぶす
pill	丸薬、錠剤
temple	寺院、こめかみ、側頭
deadly	致命的な、命にかかわる
abuse	乱用、悪用
destination	目的地、行き先
residence	住宅、居住地
plunge into	飛び込む、突進する
embarrassment	困惑、当惑
all ears	耳を傾ける、熱心に聴く
realistic	現実的な、現実に即した
inherit	を受け継ぐ、相続する
launch	発売する、船をおろす
tidy	きちんとした、整った
uncertain	不確実な、確信を持てない
scarcely	ほとんどない
token	しるし、象徴
sticky	べたつく、ねばねばした
apologize	謝罪する、あやまる
halfway	途中の、中間の
pass over	を無視する、通り越す
yawn	あくびをする
translation	翻訳
assert	主張する
consciousness	意識、知覚
surrounding	周囲、付近
crawl	這う、這って進む
wilderness	荒野、未開の地
detective	探偵、刑事、捜査官
seal	密閉する、封鎖する
measurement	測定、計測
depart	出発する、立ち去る
determination	決定、決断
take offense at	に怒る、腹を立てる
preach	説教する、説く
scenery	風景
efficiency	効率性、能力、効率の良さ
to no avail	無駄に、役に立たずに
in the concrete	具体的に、具体化すると
competitor	競合他社、競争相手
drag on	長引く、続きすぎる
mercy	慈悲、哀れみ
differ	違う、異なる
infringe on	侵害する、侵犯する
formerly	以前は、かつて
favorable	好ましい、有利な
sew	縫う、繕う
pertain to	に関係する、にふさわしい
sting	刺す、突く
lie on	責任がある、のしかかる、横になる
adjustment	調整、調節
confession	告白、自白
artistic	芸術的な
chemistry	化学／化学的な
boil down to	煮詰める、結局、になる
scent	香り、におい
wicked	邪悪な、悪い
ups and downs	浮き沈み、上昇と下降
triumph	勝利
equate A with B	AとBを等しくする、AをBと同等にする
correctly	正しく、適切に
await	を待つ
agricultural	農業の
conscience	良心、道徳心
heal	癒す、治す
profitable	利益のある、収益性の高い
hasten	急ぐ／急ぎ
weaken	弱める、力を失う
complain of	を訴える、の不平を言う
resemble	に似ている
butcher	肉屋
engagement	約束、取り決め
the lion's share	最大の分け前、大きすぎる分け前
humble	卑しい、粗末な
sleep in	寝床に入る、ゆっくり寝る
aquarium	水族館
blend in	溶け合う、調和する
ignorance	無知、無学
flare up	急に燃え上がる、勃発する
commerce	商業、商売
clap	手をたたく
dusty	埃っぽい
unkind	不親切な、薄情な
pavement	舗装路
rule of thumb	親指で計測すること、大雑把な方法
fall prey to	の餌食になる、犠牲になる
restrain	抑える、抑制する
imperial	帝国の
pass off	次第に消える、徐々に消える
advertisement	広告、宣伝
fall in with	と知り合いになる、交際する
betray	裏切る、だます
coward	腰抜け、臆病者
obedient	従順な、素直な
kidnap	を誘拐する
ashtray	灰皿
pass for	として通る、通過する
porter	運搬人
faithful	忠実な、誠実な
hollow	くぼみ／空洞のある
after all	結局、最後は
hidden	隠された、隠秘の
limb	手足
admiration	感心、賞賛
prosperity	繁栄、成功
enthusiastic	熱狂的な、熱烈な
surrender	降伏する、投降する
miserable	悲惨な、みじめな
decay	腐る、朽ちる
enclose	を囲む、同封する
ambitious	野心的な、大志を抱く
bear the brunt of	の矢面に立つ、まともに受ける
guilt	罪悪感、有罪
occasional	時折の
take a beating	負ける、敗北する
puppy	子犬、幼犬
greedy	貪欲な、欲張りの
admire A for B	BについてAを賞賛する、AのBを素晴らしいと思う
bestow A on B	BにAを授ける、BにAを費やす
envy	うらやみ、ねたみ
partial	部分的な、一部の
awfully	ひどく、恐ろしく
by the same token	同様に、さらに
razor	かみそり
nap	昼寝、ひと眠り
rejoice	をうれしがる、喜ぶ
heroic	英雄的な、勇ましい
descend	下降する、降りる
multiply	掛け算する、乗算する
make haste	急ぐ、手早くする
drum up	呼び集める、募集する
formation	形成、構成
namely	すなわち、つまり
mighty	強力な、精力のある
pop up	飛び出す、出現する
handful	一握りの
pronounce	を発音する
pay down	頭金として払う、即金で払う
saucer	受け皿
outer	外に、外部の
despair	絶望、失望
antique	骨董の、古風な
glory	栄光、名誉
immense	巨大な、莫大な
faint	かすかな、ぼんやりした
insult	侮辱する、はずかしめる
forecast	を予測する
chew	を噛む
set forth	説明する、を明らかにする
scholarship	奨学金、育英資金
fatal	致命的な、運命の
repay	返済する、報いる
deceive	を欺く、だます
out of the woods	森の外へ、困難を脱して
salty	塩辛い、塩のきいた
in other words	言い換えれば、他の言葉で言うと
frankly	率直に、直接的に
land A with B	AにBを引き受けさせる、AにBをやらせる
ache	痛み
actively	積極的に、活発に
composer	作曲家
postpone	を延期する、延ばす
issue A to B	AをBに支給する、発行する
from hand to mouth	その日暮らしで、将来の備えをしないで
monument	記念碑
cruelty	残酷さ、残虐性
go nuts	気がふれる、怒り狂う
canal	運河
amaze	をびっくりさせる、驚かせる
prolong	を延長する、延ばす
bud	つぼみ
hatred	憎しみ、憎悪
splendid	素晴らしい、華やかな
basin	盆地、たらい
bleed	出血する、血を流す
ripe	熟した、熟れた
thorough	徹底した、完璧な
digest	要約／消化する
rattle	ガタガタ鳴る
athletic	競技の、運動家の
sidewalk	歩道、歩行者道
fasten	を固定する、締める
dish out	盛り付ける、配膳する
interpreter	解説者、通訳者
scold	を叱る、に小言を言う
ruling	支配的な、主要な、優勢な
thoroughly	徹底的に、完全に
paragraph	段落、区切り
cast off	投げ捨てる、縄を解く
vain	うぬぼれが強い
marvelous	素晴らしい
conquer	を征服する、制圧する
obey	従う、服従する
dive	飛び込む
injured	怪我した、傷つけられた
pass on	通り過ぎる、を伝える
lipstick	口紅
merrily	陽気に、楽しそうに
sorrow	悲しみ、悲哀
in exchange	引き換えに、交換として
hillside	山腹、斜面
hasty	急ぐ、急ぎ足で
margin	余白、へり
in place of	の代わりに、変わって
swift	迅速な、速い
oral	口頭の、口述の
to excess	過剰に、過度に
ambassador	大使
concentrated	濃縮された、集中した
flu	インフルエンザ
in the suburbs of	の郊外で、の近郊で
symphony	交響曲
tread	足を踏み入れる
hasten	急がせる
pastime	娯楽、気晴らし
magnificent	壮大な
errand	使い走り
pass through	を通る、通り抜ける
fairness	公平さ
make allowance for	を大目に見る、を考慮に入れる
hedge	垣根、障壁、障害物
out in the cold	冷たくされて、無視されて
patiently	辛抱強く、根気よく
herd	群れ、集団
out of bounds	立入禁止で、境界線を越えて
approximately	おおよそ、だいたい
liver	肝臓、肝
be reckless of	を気に掛けない、気にしない
dominant	支配的な
shrink	縮小する、縮む
instantly	すぐに、直ちに、即座に
biology	生物学
feed on	にエサをやる、（～を）餌とする
scarce	乏しい、不足している
at close quarters	間近に、接近して
vigor	活力
capitalism	資本主義
conquest	征服、克服
sparkle	キラキラ輝く、きらめく
arena	舞台、闘技場
pinch	をつねる、つまむ
embroil in	に巻き込む、関与させる
attain	を達成する、獲得する
speak ill of	の悪口を言う、を悪く言う
emotionally	感情的に、情緒的に
assign	割り当てる、あてがう
die down	下火になる、（騒ぎが）静まる
all told	全体で、結局
blow in	風が吹き込む、突然現れる
grind	をひく、細かく砕く
plow	耕作用すき、すき似たもの
prohibit	禁じる、禁止する
conceive	を心に抱く、思う
conjure up	素早く出す、呪文で呼び出す
disgusting	いやな、むかつくような
medieval	中世の、時代遅れの
fish for	聞き出す、誘い出す
fascinating	魅惑的な、うっとりさせる
dock	船着場、波止場
go under	失敗する、破産する、失敗に終わる
retreat	へ退却する／後退
productivity	生産性、生産力
feed off	から取って食べる、情報を得る、採取して利用する
shiny	輝いた、光沢のある
organism	生命体、生物
sow	の種をまく
buy over	買収する、味方に抱き込む
courageous	勇気のある、勇敢な
kneel	に膝まづく、ひざをつく
procession	行列
carry off	運び去る、誘拐する
majesty	威厳
suspicion	疑い、疑惑
desperately	必死に
startle	驚愕させる
heir	相続人、跡取り
illusion	幻覚、思い込み
progressive	進歩的な、革新的な
utter	完全な、まったくの
mourn	を悲しむ、嘆く
round and round	ぐるぐる、うろうろ
solely	単独で、専ら
ill at ease	落ち着かない、不安な
strive	努力する、励む
snatch	をひったくる
omit	を省略する、省く
sole	単独の、単一の
despise	を軽蔑する、さげすむ
obedience	従順、服従
boredom	退屈
furnish	家具を備える
daring	大胆な、図太い
appreciation	感謝、称賛
prosper	繁栄する、発展する
rosy	バラ色の
noticeable	目立つ、際立つ
fantastic	素晴らしい
get wet to the skin	ずぶ濡れになる、びしょ濡れになる
vivid	鮮やかな
least of all	とりわけ、最も～ない
brutal	残忍な、残酷な
disguise	変装させる、見せかける
consult	相談する、話し合う
frustration	欲求不満、落胆
cunning	ずる賢い
make a fuss	大騒ぎする、騒ぎ立てる
let on	漏らす、白状する
prescription	処方箋、処方
particle	分子、微量
hug	抱擁、抱きしめる
absurd	ばかげた、道理に合わない
run down	流れ落ちる、荒廃する
assemble	を集める、組み立てる
pick up the pieces	欠片を拾う、事態を修復する
refusal	拒否、拒絶
uncertainty	不確実性、不明確さ
conceal	隠す、秘密にする
expedition	遠征
unjust	不当な、不公平な
tragic	悲劇的な、悲劇的
edit	を編集する
declaration	宣言、発表
vow	誓い、誓約
tighten	締める、絞る
barge in	入り込む、押しかける
tolerate	に耐える、寛大に取り扱う
gloomy	憂鬱な、暗い
out of place	場違いの、不適切な
suspend	を吊るす、ぶら下げる
imitation	模倣
acquisition	取得
warrior	戦士
verb	動詞
physically	肉体的に、身体的に
elegant	優雅な、上品な
honorable	尊敬できる
anticipate	を期待する、予想する
seldom if ever	めったに～ない
volcano	火山、噴火口
sentiment	感情、心情
sleep over	外泊する、を見落とす
severely	厳しく、ひどく
flexible	柔軟な、しなやかな
feast	ごちそう、祝祭
eagerly	熱心に
soar	舞い上がる
fertile	肥沃な、多産の
rule out	を除外する、締め出す
overhead	間接の
modify	修正する、変更する
scary	怖い
pile in	どっと中に入る、一気に入る
comprehension	理解
try out	を試す、十分に試してみる
irony	皮肉
surgeon	外科医、手術医
lick	をなめる、をなめてかかる
refuge	避難、保護
bow out	お辞儀して退出する、身を引く
bulk	大きさ、かさ
peel	皮をむく／皮
lastly	最後に、結局
grieve	深く悲しむ、嘆く
snap out of	から素早く脱出する、抜け出す
forehead	おでこ、ひたい
productive	生産的な
aisle	通路
sphere	球体、球
right off	すぐに、直ちに
insure	を保証する
dense	密な、密集した
dip	に少し浸す
distress	苦痛、苦悩
prominent	目立つ、突き出た
statesman	政治家
bowl over	を打ち倒す、仰天させる
experimental	実験的な、実験の
isolated	孤立した、隔離された
cast away	投げ捨てる、処分する
likewise	同様に
bank on	を当てにする、頼る
sue	訴える、訴訟を起こす
remedy	治療
electronics	電気製品
fluent	流暢な
farewell	別れ
in token of	の証拠に、のしるしとして
fierce	激しい、凶暴な
sprinkle	を振りかける
prevail	打ち勝つ
with open arms	両手を広げて、心から喜んで
patron	常連客、保護者
fetch	を取ってくる
plead	懇願する、お願いする
consensus	同意、同調
suspicious	疑わしい、怪しい
accurately	正確に、綿密に
be devoid of	をを持っていない、に欠いている
resign	辞任する、辞職する
stain	汚れ
buck for	得ようと努める、求める
oriental	東洋の
be indebted to	に負債がある、恩義がある
dissolve	を溶かす
moderate	適度な、適切な、ほどよい
microwave	電子レンジ
imperfect	不完全な、未完成の
torch	たいまつ
run errands	使い走りをする、お使いをする
trim	を整える、手入れする
defect	欠陥、欠点
optimistic	楽観的な、前向きな
evaluation	評価、査定
attendant	付き添い、付随
rag	ぼろきれ、布切れ
rib	肋骨、あばら骨
condense	を凝縮する、濃縮する
in a nutshell	一言で言えば、極めて簡単に言えば
wit	機転
be bound up with	と密接な関係のある、深く関係した
unaware	気づいていない
sacred	神聖な、神の
faithfully	忠実に、誠実に
flourish	繁栄する、栄える
accomplishment	完成、業績
to say the least	控えめに言っても、遠からず
diligent	勤勉な
clay	粘土
regulate	を規制する、統制する
misfortune	不幸、災厄
forbid	を禁じる、禁止する
inspiration	ひらめき、思い付き
gleam	きらめき、薄明かり
protective	保護的な、保護する
onward	前進の、前進的な
inquire after	の安否を尋ねる、を見舞う
immensely	莫大に、広大に
down the drain	排水路に流されて、失われて
promptly	早速、即座に
bump	こぶ、衝突
cover for	を覆う、代理となる
ward	区画、病室
freshman	新入生
refine	を精製する
dim	薄暗い、ほの暗い
resume	再開する、続ける
eternal	永遠の、永遠不変の
brush off	をすげなく断る、無視する、拒否する
be obsessed with	に取り付かれる、で頭がいっぱい
colonial	植民地の
arithmetic	算数
esteem	を尊重する、尊敬する
currency	通貨、貨幣
ridiculous	ばかげた、おかしな
calculation	計算、算定
terrific	すごい、ものすごい
stitch	縫い目
pasture	牧草、牧草地
bargain for	について交渉する、話し合う
boil over	沸騰してこぼれる、憤慨する
thorn	とげ、茨
twilight	黄昏時
moan	うめき声
lame	不十分な
legally	合法的に、法律上
have off	取り外す、休暇を取る
seemingly	一見すると、表面上
singular	特異な、非凡な
condemn	を責める、非難する
unbelievable	信じられない、信じがたい
pick up the thread	再び続ける、再開する
creativity	創造性、独創性
passionate	情熱的な、熱情的な
tide over	乗り切る、切り抜ける
diplomatic	外交の、外交上の
widow	未亡人、夫を亡くした女性
swallow up	飲み込む、使い尽くす
deadline	締め切り、期限
pore over	を凝視する、熟読する
proclaim	を宣言する、公表する
enlarge	を拡大する、大きくする
iron out	解決する、しわを伸ばす
stern	厳格な、断固とした
ivory	象牙、象牙質の
outlet	出口
day in, day out	明けても暮れても、毎日毎日
steer	を操縦する、かじを取る
hay	干し草
erect	直立の、まっすぐな
stumble	につまずく
bug	虫、故障
grim	厳格な、険しい
cathedral	大聖堂
robbery	強盗、強盗罪
slap	平手打ち
awkward	ぎこちない、不器用な
lark	戯れ
separation	分離、分割
makeup	化粧
dye	染料
swell	膨れる、大きくなる
mingle with	と混ざる、交じる
organic	無農薬の、有機の
ideally	理想的には、申し分なく
for the good of	のために、の（利益の）ために
dread	ひどく怖がる、恐れる
oblige	義務づける、強制する
perish	滅びる、死ぬ
barn	納屋、物置
economist	経済学者
delightful	楽しい、うれしい
exaggerate	を誇張する、大げさに言う
in the abstract	理論上は、理論的には
give way	道を譲る、くじける
continuous	継続的な、持続的な
proven	証明された
unity	団結、単一
destiny	運命、使命
recess	休憩、休み
shelf life	保存可能期間、賞味期間
abundance	豊富
tear off	引きちぎる、脱ぎ捨てる
witch	魔女、魔法使い
capitalize on	を利用する
glorious	栄光のある、名誉ある
damp	湿った
dispose	を廃棄する、配置する
unacceptable	受け入れられない
thermometer	温度計
groan	うめき声、うなり声
oversleep	寝坊する、寝過ごす
violate	を違反する、破る
frequency	周波数、頻繁さ
agony	激しい苦痛、苦悶
trifle with	ぞんざいに扱う、適当に扱う
tempt	を誘惑する
uncommon	珍しい、滅多にない
famine	食料不足、飢饉
punctual	時間に正確な、時間通りの
deal with	を扱う、論じる
abound in	であふれている、に富む
summon	を召喚する、呼び出す
twinkle	きらきら光る
wrestle with	取っ組み合う、取り組む
howl	遠吠えする
word for word	一言一句、文字通りに
stubborn	頑固な、固執する
greenhouse	温室、ビニールハウス
life expectancy	余命、残りの寿命
flatter	にお世辞を言う
inhabit	に生息する、住む
frown	眉をひそめる、しかめっ面
psychology	心理学
build up	増大する、築き上げる
prudent	用心深い、慎重な
air out	が乾く、乾燥する
want for	に欠ける、必要とする
genuine	本物の、真の
conductor	導体、指導者
not absolutely	絶対ではない、必ずしも～ではない
odds and ends	がらくた、半端なもの
publisher	出版社
wind up	巻き上げる、終わりにする
monarch	君主、王
blaze	火炎、炎
heap	山
exclaim	を叫ぶ、大声で言う
sob	すすり泣く、涙声で泣く
chaos	混沌
exploration	探査、探索
nightmare	悪夢
reservation	予約、指定
prevention	防止、予防
in the mood for	したい気分である、する気になっている
undertake	を引き受ける、着手する
root out	根絶する、一掃する
by dint of	によって、の力で
reluctant	しぶしぶの、気が進まない
neutral	中立の、公平な
no sweat	容易に、お安い御用で
influential	影響力のある、有力な
cut down	を減らす、削減する
in disguise	変装した、～したふり
turn pale	青ざめる、血色が悪くなる
midday	真昼、正午
acquaint	に知らせる、告げる
in anticipation of	を予期して、見込んで
apparatus	器具、装置
cradle	ゆりかご
noun	名詞
foam	小さな泡、微細な泡
forgetful	忘れっぽい、忘れやすい
disgrace	不名誉
scar	傷跡
disappointed	がっかりした、当ての外れた
track down	の跡を辿る、追い詰める
grocery	食料品
throne	王位、王座
pullover	路肩に寄せる
accommodation	宿泊施設
architect	建築家
stride	大きく歩く、元気よく歩く
mummy	ミイラ
assignment	宿題、課題
impatient	せっかちな、性急な
inquire	を問い合わせる、尋ねる
murmur	つぶやく
acute	鋭角の、鋭い
undergraduate	大学生、学部生
rest on	に基づく、に頼る
invasion	侵入、侵略
plunge	突入する、侵入する
perfume	香水、芳香
halt	立ち止まる、停止する
provider	生産者、製造者
mischief	いたずら
sneeze	くしゃみ
roar	とどろく、吠える
for instance	例えば、たとえ…としても
keep down	身を低くする、大きな声を出さずにいる
plainly	明白に、はっきりと
by default	既定では、初期段階から
shipping	輸送、発送
architecture	建築
inflict A on B	BにAを与える、負わせる
uncover	を明らかにする、ふたを取る
embassy	大使館
pessimistic	悲観的な
assurance	保証、請け合い
evaluate	を評価する、見積もる
pull through	を乗り越える、を超える
graceful	優雅な、上品な
abolish	を廃止する、やめる
in spite of	にも関わらず、けれども
carve	を彫る
miss out	機会を逃す、見落とす、見過ごす
portray	描く、表現する
catch a glimpse of	をちらっと見る、垣間見る
remarkably	著しく、非常に
exceed	を超える、超過する
revive	生き返る
deprive	から奪う、略奪する
far cry from	叫び声から遠い、からほど遠い
legend	伝説、言い伝え
incredible	信じられない、信じがたい
overtake	を追い越す、追いつく
harmless	無害な
consent	同意する、賛成する
ornament	装飾品、飾り
send in	に送る、提出する
idiot	馬鹿
plural	複数の
provincial	地方の
removal	除去、取り除く
mentally	精神的に、心理的に
work off	徐々に取れる、減らす
brim	へり、ふち
dwelling	住居
gravity	重力、引力
diverse	多様な、多種多様な
pledge	誓約、固い約束
anticipation	期待、予想
simultaneously	同時に
soak	浸す、浸漬する
supplement	補足、追加
inevitably	必然的に
crouch	しゃがむ、かがむ
branch out	枝を出す、手を広げる
in abundance	大量に、豊富に
rip	を裂く、破る
supervision	監督、指導者
comical	おどけた、滑稽な
counsel	弁護士、協議
cheat on	でズルをする、裏切る
metaphor	比喩、隠喩
compensation	補償、賠償
impolite	失礼な、無礼な
pastry	パン菓子
remainder	残り、残りもの
biography	伝記
persistent	根気強い、粘り強い
rubbish	ごみ、がらくた
shameful	恥ずべき
edge out	徐々に押しのける、辛勝する
vanity	虚栄心、うぬぼれ
umpire	審判、審判員
intensity	強度、強烈さ
diplomat	外交官、外交官僚
exert oneself to	～するために努力する、～のために尽力する
naval	海軍の、海軍のもの
sway	揺さぶる
microscope	顕微鏡、測微鏡
probe	探り針
geometry	幾何学
fuzzy	ぼやけた
skyscraper	超高層建築物、摩天楼
deceit	詐欺、騙し
rebellion	反乱、暴動
isolation	隔離、孤立
lay down	を横たえる、倒す
nobility	尊さ、高貴さ
spit	唾を吐く
think out	考え抜く、熟考する
obstacle	障害物、邪魔
chairperson	議長
embarrassed	恥ずかしい、照れる
plentiful	たっぷりの、たくさんの
all thumbs	不器用な、ぶざまな
orchard	果樹園
fatigue	疲労、疲れ
attendance	出席、参列
come around	遠回りする、立ち寄る
probability	確率
prediction	予測、予想
ownership	所有権
equation	方程式
accounting	会計、計算
shatter	を粉砕する
preliminary	予備的な、予備の
endurance	忍耐、我慢
fleet	艦隊
stand over	を監督する、延期する
comet	彗星
cozy	居心地の良い、快適な
speculation	憶測、推測
execute	を実行する、遂行する
have a flat tire	タイヤがパンクする、パンクしている
masterpiece	傑作、名作
nun	修道女
be keen to	やる気がある、乗り気になっている
discrimination	差別、区別
wash away	を洗い流す、を洗い落とす
bounce	跳ねる、はずむ
blueprint	青写真
bring about	を引き起こす、発生させる
disturbing	邪魔な、迷惑な
attentive	注意深い
take root	根付く、定着する
mock	をあざ笑う、ばかにする
identify A as B	AがBだと分かる、認識する
receptionist	受付係
identification	身分証明書、身元確認
prey	獲物、捕食対象
shrine	神社、聖堂
solitary	独りの、独りぼっちの
jack up	吊り上げる、ジャッキで上げる
magnetic	磁気の、磁石の
cue	合図、きっかけ
scramble	をかき混ぜる、素早く進む
councilor	評議員
federation	連合、連盟
in short	つまり、要するに
inexpensive	安価な、費用のかからない
astronomer	天文学者
multitude	大勢、多く
lumber	木材
hostile	敵意のある、反感を持つ、敵対視する
bilingual	二ヶ国語話者、バイリンガル
insistence	主張、信条、主義
administrative	運営の、管理の
staircase	階段
inheritance	継承、相続
accuracy	正確さ、精密さ
mortal	死を伴う
liner	定期船
abrupt	急な、不意の
registration	登録
exhaustion	枯渇、疲労
call down	下に向かって叫ぶ、叱りつける
cluster	集団
script	台本、脚本
infectious	伝染性の、感染する
odor	臭い、悪臭
ample	広大な、広い
ornamental	装飾用の
dullness	鈍さ、鈍感
indication	指示、指し示すこと
certificate	証書、証券
remembrance	記憶、思い出
jerk	急な動き
orient	東洋
offspring	子孫
counterpart	相手
documentary	事実を記録した
scrape	を削り取る
dedicate	を奉納する、捧げる
astronaut	宇宙飛行士
naughty	わんぱくな、いたずらな
pregnancy	妊娠
comparable	比較できる、比べられる
haunt	にたびたび行く
trash	ごみ、価値のないもの
outskirt	郊外
valid	有効な、根拠のある
behind the scenes	舞台裏で、陰で
mellow	豊潤な、熟した
paw	動物の足
genetic	遺伝的な、遺伝による
stimulus	刺激
spectacular	壮観な、見事な
villa	別荘
chilly	肌寒い
crook	湾曲させる
costly	高価な、費用のかかる
coarse	粗末な、下等な
buy up	全部買う、買収する
accusation	非難、告発
transaction	取引、処理
stupidity	愚かさ、愚鈍
leak	漏れ
tuck	を押し込む、詰め込む
without so much as	さえしないで、すらしないで
rack	置き棚
avail oneself of	を利用する、を活用する
hesitation	ためらい、躊躇
utility	効用
furthermore	その上に、さらに
exclusive	閉鎖的な、内向的な
signify	意味する、示す
stick up	上に突き出る、両手を挙げさせる
exclusively	排他的に、限定して
diversity	多様性、多様化
vocal	音声の、声の
exceptional	例外の、まれな
in all likelihood	おそらく、ほぼ確実に
irresponsible	責任を負えない、無責任な
distinctive	特有の、独特の
faraway	遠くの
puff	軽く吹くこと、一吹き
sincerity	誠意、誠実さ
beyond question	疑いもなく、確かに
vicious	悪意のある、意地悪な
starvation	飢餓、餓死
slip of the tongue	失言、口を滑らせる
stack	積み重ねる、累積する
rely on	に頼る、を当てにする
alongside	と一緒に、並行して
spring from	から生じる、から生まれる
monopoly	独占、専売
reckless	無謀な、向こう見ずな
strip A of B	AからBを取り去る、奪う
retail	小売り
utilize	活用する
take the plunge	思い切ってやる、やってみる
withdrawal	撤回、撤退
disclose	を開示する、見せる
put emphasis on	に重点を置く、を重んじる
puppet	操り人形、指人形
hold off	を寄せ付けない、引き離す
provoke	挑発する、引き起こす
stony	石の、石の多い
ethics	倫理
gun for	を追い求める、必死になる
stoop	かがむ
regain	を取り戻す、回復する
alley	路地
innovation	革新、刷新
shiver	震える、おののく
inadequate	不十分な、不適切な
fulfillment	遂行
overtime	延長時間、超過時間
exploit	偉業、業績
deliberately	故意に、慎重に
feminist	男女同権主義者、フェミニスト
stump	切り株
hail from	の出身である、（船が）から来る
unfold	を展開する、広げる
dialogue	対話
vacant	空っぽの、無人の
commodity	商品、必需品
residential	居住の、住居の
pin down	をピンで留める、押さえつける
accountant	会計士、会計係
compel	無理にさせる
architectural	建築の
inspection	検査、点検
patent	特許
gateway	出入口
bear down	圧迫する、制圧する
fluid	液体、流動体
decent	まともな、ふさわしい
brighten	を明るくする、光らせる
revise	を改訂する、修正する
proficient	熟練した、堪能な
rally	を結集する、呼び集める
fit into	に溶け込む、調和する
outsider	部外者、第三者
accessible	行きやすい、便利な
as a last resort	最後の手段として、切羽詰まって
penetrate	を貫く、に入り込む
head over heels	真っ逆さまに、逆さまに
accommodate	収容する
peck	をついばむ、つつく
spacecraft	宇宙船
be weary of	にうんざりしている
considerably	かなり、相当に
stray	迷い込む
resemblance	類似
institutional	制度の、制度上の
plague	伝染病
glimpse	ひと目見ること
fuss	空騒ぎ
importantly	重要なことに
be doomed to	運命づけられる、の運命にある
insert	を差し込む、挿入する
pretense	見せかけ
sheer	本当の、透けるほど薄い
to begin with	最初に、最初から
coordinate	座標の、同等の／整合する
checkup	調べる／検査
applaud	拍手する
ethical	倫理的な
shady	陰になった、日陰になった
preservation	保存、保護
rust	さび
flexibility	柔軟性
be destitute of	に困窮する、を持っていない
virgin	処女
clause	条項、節
transmit	送信する
reproach A for B	BのことでAを非難する、咎める
denial	拒否、否定
nobleman	貴族
stale	古くさい、新鮮でない
talk back to	に口答えする、言い返す
depressed	落ち込んだ、憂鬱な
quest	探求、探究
overthrow	を打倒する、転覆する
excursion	遠足
fragment	断片
watchdog	番犬
bald	禿げた
mutter	つぶやく
back off	後退する、後ろに下がる
ridge	尾根
adjective	形容詞、形容する言葉
classify	に分類する、類別する
collective	集団的な
cooperate	協力する、共同する
sober	酔っていない
frustrate	挫折させる
envious	羨ましい、妬ましい
step down	降りる、身を引く
cooperative	協力的な
donation	寄付、寄贈
overwhelm	圧倒する、制圧する
structural	構造上の、構成上の
librarian	図書館員
rigid	堅い
authorize	許可する
marvel	驚異、驚き
fling	を投げ飛ばす
transmission	伝送
peep	のぞき見る
endeavor	努力する
hang around	ぶらぶらする
physicist	物理学者
immature	未熟な
outbreak	発生
manuscript	原稿
stagger	よろめく、よろよろ歩く
slam	強く閉める
banish	を流刑にする、追放する
swamp	沼地、湿地
conform to	に適合する
capability	能力
molecule	分子
what if	もし～なら
participation	参加
faculty	学部
head off	を阻止する
courtesy	礼儀
midst	真ん中
resent	憤慨する
undo	元に戻す
lad	少年
loosen	緩める
riddle	なぞなぞ
corruption	腐敗
extract	抽出する
speaking of which	ところで
unconscious	無意識の
rebuild	再建する
by contract	契約によって
curse	呪う
